AAAACACAATG -> AAACACAATGT
AAAACTTCTCC -> AAACTTCTCCA
AAAAGTGCTAT -> AAAGTGCTATG
AAAATGTAGAT -> AAATGTAGATA
AAAATTCCGGA -> AAATTCCGGAT
AAACACAATGT -> AACACAATGTA
AAACCGAGGAC -> AACCGAGGACA
AAACTCCGGGC -> AACTCCGGGCT
AAACTGGACTG -> AACTGGACTGC
AAACTTCTCCA -> AACTTCTCCAC
AAAGAACAATT -> AAGAACAATTA
AAAGACAGCGC -> AAGACAGCGCT
AAAGCGTGTTG -> AAGCGTGTTGA
AAAGGTGACGT -> AAGGTGACGTA
AAAGTGCTATG -> AAGTGCTATGT
AAAGTTATTGT -> AAGTTATTGTT
AAATAAGAGAC -> AATAAGAGACC
AAATAGTCCTT -> AATAGTCCTTA
AAATATGCATC -> AATATGCATCA
AAATGACTCTG -> AATGACTCTGG
AAATGTAGATA -> AATGTAGATAG
AAATTCCGGAT -> AATTCCGGATA
AACAACTGCAC -> ACAACTGCACA
AACAAGTGACG -> ACAAGTGACGG
AACAATACGAG -> ACAATACGAGG
AACAATTACAA -> ACAATTACAAT
AACACAAAGGT -> ACACAAAGGTG
AACACAATGTA -> ACACAATGTAG
AACACACCATT -> ACACACCATTT
AACACGTCTCC -> ACACGTCTCCC
AACACTTCGCA -> ACACTTCGCAA
AACAGACCATG -> ACAGACCATGC
AACAGATCCTG -> ACAGATCCTGA
AACATGCAAGC -> ACATGCAAGCC
AACATGGAAAG -> ACATGGAAAGT
AACATGTGCCG -> ACATGTGCCGG
AACCATCGAAA -> ACCATCGAAAA
AACCGAGGACA -> ACCGAGGACAG
AACCGGCGAGC -> ACCGGCGAGCT
AACGCATGTGC -> ACGCATGTGCC
AACGCCTACAC -> ACGCCTACACC
AACGCCTGGCG -> ACGCCTGGCGA
AACGGCAAGAC -> ACGGCAAGACT
AACGTCTACAA -> ACGTCTACAAA
AACTATAGTGA -> ACTATAGTGAG
AACTCCGGGCT -> ACTCCGGGCTA
AACTGCACAGA -> ACTGCACAGAC
AACTTCTCCAC -> ACTTCTCCACG
AAGAACAATTA -> AGAACAATTAC
AAGACAATTTC -> AGACAATTTCG
AAGACAGCGCT -> AGACAGCGCTC
AAGACTGCACC -> AGACTGCACCG
AAGACTGCCGA -> AGACTGCCGAC
AAGACTGGGGT -> AGACTGGGGTT
AAGAGACCGCC -> AGAGACCGCCC
AAGAGTCTGCT -> AGAGTCTGCTT
AAGATACACGT -> AGATACACGTC
AAGATTGGACA -> AGATTGGACAT
AAGCATACTCA -> AGCATACTCAG
AAGCATGCACC -> AGCATGCACCG
AAGCCGCAAAC -> AGCCGCAAACT
AAGCGATGATT -> AGCGATGATTT
AAGCGGGTATT -> AGCGGGTATTT
AAGCGTGTTGA -> AGCGTGTTGAC
AAGCTTACCAG -> AGCTTACCAGC
AAGGACGTCAC -> AGGACGTCACC
AAGGATCAGGA -> AGGATCAGGAA
AAGGCTTCTCG -> AGGCTTCTCGT
AAGGGAGGTTC -> AGGGAGGTTCT
AAGGGGAGGTA -> AGGGGAGGTAT
AAGGTCCGGCG -> AGGTCCGGCGA
AAGGTGACGTA -> AGGTGACGTAC
AAGGTGCGCAG -> AGGTGCGCAGG
AAGTAAGTGAC -> AGTAAGTGACA
AAGTACATTAC -> AGTACATTACC
AAGTCTAGGCC -> AGTCTAGGCCA
AAGTGACACAG -> AGTGACACAGG
AAGTGACGGTA -> AGTGACGGTAC
AAGTGCTATGT -> AGTGCTATGTT
AAGTTATTGTT -> AGTTATTGTTA
AATAAGAGACC -> ATAAGAGACCG
AATAAGATTGG -> ATAAGATTGGA
AATAATAATGG -> ATAATAATGGT,ATAATAATGGT
AATAATGGTGC -> ATAATGGTGCA
AATAATGGTGG -> ATAATGGTGGT
AATACCATTTC -> ATACCATTTCA
AATACGAGGTA -> ATACGAGGTAC
AATACTCTTAA -> ATACTCTTAAC
AATAGTCCTTA -> ATAGTCCTTAC
AATATAAGAGT -> ATATAAGAGTC
AATATGCATCA -> ATATGCATCAC
AATCACGTTAG -> ATCACGTTAGA
AATCTGACGCT -> ATCTGACGCTG
AATCTGGACCC -> ATCTGGACCCA
AATGACTCTGG -> ATGACTCTGGC
AATGCGCGGTA -> ATGCGCGGTAT
AATGCTAACAA -> ATGCTAACAAT
AATGGAACCAT -> ATGGAACCATC
AATGGCCTCGC -> ATGGCCTCGCC
AATGGTGCACT -> ATGGTGCACTC
AATGGTGGTAC -> ATGGTGGTACC
AATGTAATACC -> ATGTAATACCA
AATGTAGATAG -> ATGTAGATAGC
AATGTAGCTTG -> ATGTAGCTTGC
AATTACAATCT -> ATTACAATCTG
AATTACAGGCC -> ATTACAGGCCA
AATTCCGGATA -> ATTCCGGATAT
AATTCGACACC -> ATTCGACACCT
AATTGGACACC -> ATTGGACACCG
AATTGGCACCT -> ATTGGCACCTG
AATTGTGTTAA -> ATTGTGTTAAC
AATTTCGTTAC -> ATTTCGTTACC
ACAAAATTCCG -> CAAAATTCCGG
ACAAAGAACAA -> CAAAGAACAAT
ACAAAGGTGAC -> CAAAGGTGACG
ACAACATGTGC -> CAACATGTGCC
ACAACTGCACA -> CAACTGCACAG
ACAAGGTCCGG -> CAAGGTCCGGC
ACAAGTACATT -> CAAGTACATTA
ACAAGTGACGG -> CAAGTGACGGT
ACAATACGAGG -> CAATACGAGGT
ACAATCTGACG -> CAATCTGACGC
ACAATGTAGCT -> CAATGTAGCTT
ACAATTACAAT -> CAATTACAATC
ACAATTTCGTT -> CAATTTCGTTA
ACACAAAGGTG -> CACAAAGGTGA
ACACAACATGT -> CACAACATGTG
ACACAATGTAG -> CACAATGTAGC
ACACACCATTT -> CACACCATTTA
ACACAGGATCT -> CACAGGATCTC
ACACAGGCCTT -> CACAGGCCTTC
ACACATGCCCA -> CACATGCCCAG
ACACCATTTAA -> CACCATTTAAT
ACACCCGCCGC -> CACCCGCCGCG
ACACCGTCCGG -> CACCGTCCGGG
ACACCTCGTGT -> CACCTCGTGTG
ACACGAGCACT -> CACGAGCACTA
ACACGGTACTC -> CACGGTACTCA
ACACGTCGACG -> CACGTCGACGT
ACACGTCTCCC -> CACGTCTCCCG
ACACTCTAAGC -> CACTCTAAGCA
ACACTTCGCAA -> CACTTCGCAAC
ACAGACCAGAA -> CAGACCAGAAC
ACAGACCATGC -> CAGACCATGCC
ACAGATCCTGA -> CAGATCCTGAG
ACAGCGCTCGC -> CAGCGCTCGCC
ACAGCGTAATG -> CAGCGTAATGG
ACAGGATCTCG -> CAGGATCTCGG
ACAGGCCAGCG -> CAGGCCAGCGC
ACAGGCCTTCT -> CAGGCCTTCTG
ACAGGGAGATA -> CAGGGAGATAG
ACAGGTTTGCT -> CAGGTTTGCTG
ACAGTGGCAAG -> CAGTGGCAAGC
ACATAAGGGAG -> CATAAGGGAGG
ACATAGGCCCA -> CATAGGCCCAG
ACATATCCCGC -> CATATCCCGCA
ACATGACACAA -> CATGACACAAC
ACATGCAAGCC -> CATGCAAGCCG
ACATGCCCAGC -> CATGCCCAGCC
ACATGGAAAGT -> CATGGAAAGTT
ACATGTGCCGG -> CATGTGCCGGC
ACATTACCGCT -> CATTACCGCTA
ACATTCACCCT -> CATTCACCCTT
ACCAATAATAA -> CCAATAATAAT
ACCAGAAACCG -> CCAGAAACCGA
ACCAGAACAGA -> CCAGAACAGAT
ACCAGCTGGCA -> CCAGCTGGCAA
ACCAGGAAGTA -> CCAGGAAGTAA
ACCAGGTCCAG -> CCAGGTCCAGT
ACCATCGAAAA -> CCATCGAAAAG
ACCATGCCCTT -> CCATGCCCTTA
ACCATTTAATG -> CCATTTAATGG
ACCATTTCAGG -> CCATTTCAGGG
ACCCACCTGCT -> CCCACCTGCTA
ACCCAGTTGTA -> CCCAGTTGTAT
ACCCATATCAC -> CCCATATCACC
ACCCATGCTTA -> CCCATGCTTAG
ACCCCCGTGCC -> CCCCCGTGCCG
ACCCGCCGCGT -> CCCGCCGCGTC
ACCCTACCGTT -> CCCTACCGTTA
ACCCTTTCAAG -> CCCTTTCAAGG
ACCGAGGACAG -> CCGAGGACAGT
ACCGATCAAGA -> CCGATCAAGAC
ACCGCCCCCAT -> CCGCCCCCATT
ACCGCTACGTA -> CCGCTACGTAT
ACCGGCCAACA -> CCGGCCAACAC
ACCGGCGAGCT -> CCGGCGAGCTG
ACCGGGACAAA -> CCGGGACAAAA
ACCGGGTCCTA -> CCGGGTCCTAC
ACCGGTAACAA -> CCGGTAACAAG
ACCGTCCGGGA -> CCGTCCGGGAC
ACCGTGTGCAA -> CCGTGTGCAAC
ACCGTTATAGA -> CCGTTATAGAT
ACCGTTCCGGG -> CCGTTCCGGGA
ACCTCACCAGG -> CCTCACCAGGT
ACCTCGACAGG -> CCTCGACAGGT
ACCTCGTGTGT -> CCTCGTGTGTT
ACCTGCAGCAG -> CCTGCAGCAGG
ACCTGCTACTG -> CCTGCTACTGA
ACCTGGTGTCC -> CCTGGTGTCCA
ACCTGTCCGAG -> CCTGTCCGAGG
ACGACACGGTA -> CGACACGGTAC
ACGAGCACTAC -> CGAGCACTACC
ACGAGGTACCT -> CGAGGTACCTG
ACGAGGTGCCT -> CGAGGTGCCTT
ACGCAACAGAC -> CGCAACAGACC
ACGCAGTGGTA -> CGCAGTGGTAG
ACGCATGTGCC -> CGCATGTGCCT
ACGCCGACTCC -> CGCCGACTCCC
ACGCCTACACC -> CGCCTACACCC
ACGCCTGGCGA -> CGCCTGGCGAG
ACGCTGAATAC -> CGCTGAATACT
ACGGATATAGC -> CGGATATAGCC
ACGGCAAGACT -> CGGCAAGACTG
ACGGGAGGCAG -> CGGGAGGCAGG
ACGGGTCGCCT -> CGGGTCGCCTC
ACGGTACACAT -> CGGTACACATG
ACGGTACTCAG -> CGGTACTCAGT
ACGGTATGCAG -> CGGTATGCAGC
ACGGTTATCTT -> CGGTTATCTTT
ACGTACGGGAG -> CGTACGGGAGG
ACGTATTGTCT -> CGTATTGTCTC
ACGTCACCAGA -> CGTCACCAGAA
ACGTCGACGTC -> CGTCGACGTCT
ACGTCTACAAA -> CGTCTACAAAG
ACGTCTCCCGG -> CGTCTCCCGGA
ACGTCTCTAAT -> CGTCTCTAATG
ACGTGGCAAAT -> CGTGGCAAATA
ACGTTAGAAAA -> CGTTAGAAAAC
ACGTTTATCCA -> CGTTTATCCAA
ACTAAATAAGA -> CTAAATAAGAG
ACTAACCGGCG -> CTAACCGGCGA
ACTACCCCCGT -> CTACCCCCGTG
ACTATAGTGAG -> CTATAGTGAGA
ACTATATCATC -> CTATATCATCG
ACTATTTAGGT -> CTATTTAGGTA
ACTCACAGCGT -> CTCACAGCGTA
ACTCACGGTAT -> CTCACGGTATG
ACTCAGAGCAT -> CTCAGAGCATC
ACTCAGTAGGG -> CTCAGTAGGGG
ACTCATGTTAT -> CTCATGTTATG
ACTCCCCGGCG -> CTCCCCGGCGT
ACTCCCCGTAC -> CTCCCCGTACT
ACTCCGGGCTA -> CTCCGGGCTAA
ACTCTAAGCAT -> CTCTAAGCATA
ACTCTACCTCA -> CTCTACCTCAC
ACTCTAGATGC -> CTCTAGATGCC
ACTCTCATAGT -> CTCTCATAGTT
ACTCTGGCACC -> CTCTGGCACCC
ACTCTTAACAC -> CTCTTAACACG
ACTGAGACCGT -> CTGAGACCGTT
ACTGCACAGAC -> CTGCACAGACC
ACTGCACCGGC -> CTGCACCGGCC
ACTGCCGACAC -> CTGCCGACACA
ACTGGGGTTGT -> CTGGGGTTGTG
ACTTCCAAGGT -> CTTCCAAGGTG
ACTTCGCAACA -> CTTCGCAACAC
ACTTCTCCACG -> CTTCTCCACGG
AGAAAACTTCT -> GAAAACTTCTC
AGAAACCGAGG -> GAAACCGAGGA
AGAACAATTAC -> GAACAATTACA
AGAACAGATCC -> GAACAGATCCT
AGAACATGGAA -> GAACATGGAAA
AGAACGGCAAG -> GAACGGCAAGA
AGACAATTTCG -> GACAATTTCGT
AGACAGCGCTC -> GACAGCGCTCG
AGACCAGAACA -> GACCAGAACAG
AGACCATGCCC -> GACCATGCCCT
AGACCGCCCCC -> GACCGCCCCCA
AGACCGGGTCC -> GACCGGGTCCT
AGACCGTTCCG -> GACCGTTCCGG
AGACTGCACCG -> GACTGCACCGG
AGACTGCCGAC -> GACTGCCGACA
AGACTGGGGTT -> GACTGGGGTTG
AGACTTCCAAG -> GACTTCCAAGG
AGAGACCGCCC -> GAGACCGCCCC
AGAGCATCGAT -> GAGCATCGATC
AGAGCCCCGAT -> GAGCCCCGATC
AGAGGCCTAAG -> GAGGCCTAAGG
AGAGTCTGCTT -> GAGTCTGCTTT
AGAGTGTGCTA -> GAGTGTGCTAG
AGATAATTGTG -> GATAATTGTGT
AGATACACGTC -> GATACACGTCG
AGATAGAGGCC -> GATAGAGGCCT
AGATAGCAGCC -> GATAGCAGCCA
AGATAGCGACA -> GATAGCGACAA
AGATATATCAC -> GATATATCACC
AGATCACCAGG -> GATCACCAGGA
AGATCCTGAGG -> GATCCTGAGGG
AGATGCATATG -> GATGCATATGG
AGATGCCCGTT -> GATGCCCGTTT
AGATGGCAACG -> GATGGCAACGT
AGATTGGACAT -> GATTGGACATG
AGCACGGATAT -> GCACGGATATA
AGCACTACCCC -> GCACTACCCCC
AGCAGCCAATT -> GCAGCCAATTG
AGCAGGCAAGC -> GCAGGCAAGCG
AGCATACTCAG -> GCATACTCAGA
AGCATCGATCG -> GCATCGATCGA
AGCATCTTTTT -> GCATCTTTTTT
AGCATGCACCG -> GCATGCACCGG
AGCATTGGTCA -> GCATTGGTCAC
AGCCAATTGGC -> GCCAATTGGCA
AGCCCCGATCT -> GCCCCGATCTC
AGCCCCTATTG -> GCCCCTATTGC
AGCCCGCGTCT -> GCCCGCGTCTC
AGCCGCAAACT -> GCCGCAAACTC
AGCCGGGCGCT -> GCCGGGCGCTA
AGCCTCCTCGA -> GCCTCCTCGAC
AGCCTCGCTGG -> GCCTCGCTGGG
AGCGACAAGGT -> GCGACAAGGTC
AGCGATACATT -> GCGATACATTC
AGCGATGATTT -> GCGATGATTTA
AGCGCATCTGA -> GCGCATCTGAT
AGCGCTCGCCT -> GCGCTCGCCTG
AGCGGGTATTT -> GCGGGTATTTA
AGCGTAATGGA -> GCGTAATGGAA
AGCGTCGCTCA -> GCGTCGCTCAC
AGCGTGTTGAC -> GCGTGTTGACA
AGCGTTGGCTT -> GCGTTGGCTTG
AGCTCGCCCAA -> GCTCGCCCAAT
AGCTGGCAAAG -> GCTGGCAAAGC
AGCTGTTCAGT -> GCTGTTCAGTG
AGCTTACCAGC -> GCTTACCAGCT
AGCTTGCTACT -> GCTTGCTACTC
AGCTTGTGAAT -> GCTTGTGAATC
AGGAAGACAAT -> GGAAGACAATT
AGGAAGATACA -> GGAAGATACAC
AGGAAGTAAGT -> GGAAGTAAGTG
AGGACAGTGGC -> GGACAGTGGCA
AGGACGTCACC -> GGACGTCACCA
AGGATCAGGAA -> GGATCAGGAAG
AGGATCTCGGT -> GGATCTCGGTT
AGGCAAGCGGG -> GGCAAGCGGGT
AGGCAGGCCGT -> GGCAGGCCGTA
AGGCATTTCAC -> GGCATTTCACC
AGGCCAGCGCA -> GGCCAGCGCAT
AGGCCATCATC -> GGCCATCATCG
AGGCCCAGCAT -> GGCCCAGCATC
AGGCCGTATCT -> GGCCGTATCTG
AGGCCTAAGGA -> GGCCTAAGGAC
AGGCCTTCTGA -> GGCCTTCTGAT
AGGCTTCTCGT -> GGCTTCTCGTT
AGGGAGATAGA -> GGGAGATAGAG
AGGGAGGTTCT -> GGGAGGTTCTA
AGGGGAATTCG -> GGGGAATTCGA
AGGGGAGGTAT -> GGGGAGGTATA
AGGGGGCTATG -> GGGGGCTATGC
AGGGGTCACTA -> GGGGTCACTAA
AGGGTGAAAAC -> GGGTGAAAACA
AGGGTTGTTGA -> GGGTTGTTGAT
AGGTACCTGTC -> GGTACCTGTCC
AGGTAGCCCCT -> GGTAGCCCCTA
AGGTAGTCAGC -> GGTAGTCAGCG
AGGTATAGATA -> GGTATAGATAA
AGGTCCAGTTT -> GGTCCAGTTTG
AGGTCCGGCGA -> GGTCCGGCGAT
AGGTGACGTAC -> GGTGACGTACG
AGGTGCCTTTG -> GGTGCCTTTGC
AGGTGCGCAGG -> GGTGCGCAGGA
AGGTGGACTCC -> GGTGGACTCCC
AGGTTCTAAGT -> GGTTCTAAGTC
AGGTTTGCTGA -> GGTTTGCTGAA
AGTAAGTGACA -> GTAAGTGACAC
AGTACATTACC -> GTACATTACCG
AGTAGGGGGCT -> GTAGGGGGCTA
AGTCAGCGATA -> GTCAGCGATAC
AGTCCTTACTA -> GTCCTTACTAT
AGTCGGCCCAC -> GTCGGCCCACG
AGTCTAGGCCA -> GTCTAGGCCAT
AGTCTGCTTTT -> GTCTGCTTTTA
AGTGACACAGG -> GTGACACAGGC
AGTGACGGTAC -> GTGACGGTACA
AGTGACTCTAC -> GTGACTCTACC
AGTGAGAACAT -> GTGAGAACATG
AGTGCCCGTGG -> GTGCCCGTGGG
AGTGCTATGTT -> GTGCTATGTTC
AGTGGCAAGCG -> GTGGCAAGCGA
AGTGGTAGCTC -> GTGGTAGCTCG
AGTGTGCTAGA -> GTGTGCTAGAG
AGTTATCTAAT -> GTTATCTAATA
AGTTATTGTTA -> GTTATTGTTAC
AGTTGTATTTA -> GTTGTATTTAG
AGTTTGTCGTA -> GTTTGTCGTAG
ATAAACTGGAC -> TAAACTGGACT
ATAAGAGACCG -> TAAGAGACCGC
ATAAGAGTCTG -> TAAGAGTCTGC
ATAAGATTGGA -> TAAGATTGGAC
ATAAGGGAGGT -> TAAGGGAGGTT
ATAATAAGATT -> TAATAAGATTG
ATAATAATGGT -> TAATAATGGTG,TAATAATGGTG
ATAATGGTGCA -> TAATGGTGCAC
ATAATGGTGGT -> TAATGGTGGTA
ATAATTGTGTT -> TAATTGTGTTA
ATACACGTCGA -> TACACGTCGAC
ATACATTCACC -> TACATTCACCC
ATACCATTTCA -> TACCATTTCAG
ATACCCACCTG -> TACCCACCTGC
ATACGAGGTAC -> TACGAGGTACC
ATACGGTTATC -> TACGGTTATCT
ATACTCACAGC -> TACTCACAGCG
ATACTCAGAGC -> TACTCAGAGCA
ATACTCTTAAC -> TACTCTTAACA
ATAGAGGCCTA -> TAGAGGCCTAA
ATAGATAATTG -> TAGATAATTGT
ATAGATGCATA -> TAGATGCATAT
ATAGCAGCCAA -> TAGCAGCCAAT
ATAGCCTCCTC -> TAGCCTCCTCG
ATAGCGACAAG -> TAGCGACAAGG
ATAGGCATTTC -> TAGGCATTTCA
ATAGGCCCAGC -> TAGGCCCAGCA
ATAGGTGGACT -> TAGGTGGACTC
ATAGTCCTTAC -> TAGTCCTTACT
ATAGTGAGAAC -> TAGTGAGAACA
ATAGTTATCTA -> TAGTTATCTAA
ATATAAGAGTC -> TATAAGAGTCT
ATATAGCCTCC -> TATAGCCTCCT
ATATATCACCG -> TATATCACCGG
ATATCACCAAT -> TATCACCAATA
ATATCACCGGT -> TATCACCGGTA
ATATCATACGG -> TATCATACGGT
ATATCATCGGG -> TATCATCGGGT
ATATCCCGCAA -> TATCCCGCAAG
ATATGCATCAC -> TATGCATCACA
ATATGGAAAAT -> TATGGAAAATG
ATCAAGACTGC -> TCAAGACTGCC
ATCAAGCATGC -> TCAAGCATGCA
ATCACATATCC -> TCACATATCCC
ATCACCAATAA -> TCACCAATAAT
ATCACCAGGAA -> TCACCAGGAAG
ATCACCGGTAA -> TCACCGGTAAC
ATCACGTTAGA -> TCACGTTAGAA
ATCAGGAAGAT -> TCAGGAAGATA
ATCATACGGTT -> TCATACGGTTA
ATCATCGGGTG -> TCATCGGGTGG
ATCATCGTTGA -> TCATCGTTGAC
ATCCAAATGAC -> TCCAAATGACT
ATCCCGCAAGA -> TCCCGCAAGAC
ATCCTGAGGGG -> TCCTGAGGGGT
ATCGAAAAGTG -> TCGAAAAGTGC
ATCGAGAGTGT -> TCGAGAGTGTG
ATCGATCGAGA -> TCGATCGAGAG
ATCGCTGATAG -> TCGCTGATAGG
ATCGGGTGGTA -> TCGGGTGGTAT
ATCGTTGACAA -> TCGTTGACAAG
ATCTAATATAA -> TCTAATATAAG
ATCTCCACCGA -> TCTCCACCGAT
ATCTCGGTTCC -> TCTCGGTTCCG
ATCTGACGCTG -> TCTGACGCTGA
ATCTGATCGCT -> TCTGATCGCTG
ATCTGGACCCA -> TCTGGACCCAG
ATCTGGTTAGC -> TCTGGTTAGCA
ATCTTTGATTC -> TCTTTGATTCG
ATCTTTTTTCG -> TCTTTTTTCGG
ATGACACAACA -> TGACACAACAT
ATGACTCTGGC -> TGACTCTGGCA
ATGATTTAGCT -> TGATTTAGCTT
ATGCAAGCCGC -> TGCAAGCCGCA
ATGCACCGGGA -> TGCACCGGGAC
ATGCAGCCTCG -> TGCAGCCTCGC
ATGCATATGGA -> TGCATATGGAA
ATGCATCACAT -> TGCATCACATA
ATGCCCAGCCC -> TGCCCAGCCCG
ATGCCCGTTTG -> TGCCCGTTTGG
ATGCCCTTAAC -> TGCCCTTAACA
ATGCCTAGCCG -> TGCCTAGCCGG
ATGCGCGGTAT -> TGCGCGGTATC
ATGCTAACAAT -> TGCTAACAATA
ATGCTAATGCG -> TGCTAATGCGC
ATGCTTAGATC -> TGCTTAGATCA
ATGGAAAATGT -> TGGAAAATGTA
ATGGAAAGTTA -> TGGAAAGTTAT
ATGGAACCATC -> TGGAACCATCG
ATGGCAACGTC -> TGGCAACGTCT
ATGGCCTCGCC -> TGGCCTCGCCG
ATGGTGAGCGT -> TGGTGAGCGTC
ATGGTGCACTC -> TGGTGCACTCT
ATGGTGGTACC -> TGGTGGTACCT
ATGTAATACCA -> TGTAATACCAT
ATGTAGATAGC -> TGTAGATAGCG
ATGTAGCATTG -> TGTAGCATTGG
ATGTAGCTTGC -> TGTAGCTTGCT
ATGTGCCGGCA -> TGTGCCGGCAG
ATGTGCCTAAA -> TGTGCCTAAAT
ATGTTATGGTG -> TGTTATGGTGA
ATGTTCAACGC -> TGTTCAACGCC
ATTACAATCTG -> TTACAATCTGA
ATTACAGGCCA -> TTACAGGCCAG
ATTACCGCTAC -> TTACCGCTACG
ATTATTCCGAA -> TTATTCCGAAC
ATTCACCCTTT -> TTCACCCTTTC
ATTCCGAACAT -> TTCCGAACATG
ATTCCGGATAT -> TTCCGGATATC
ATTCGACACCT -> TTCGACACCTC
ATTCGCGGCTT -> TTCGCGGCTTA
ATTGCGTGTAA -> TTGCGTGTAAT
ATTGGACACCG -> TTGGACACCGT
ATTGGACATGA -> TTGGACATGAC
ATTGGCACCTG -> TTGGCACCTGG
ATTGGTCACGC -> TTGGTCACGCA
ATTGTCTCCAC -> TTGTCTCCACT
ATTGTGTTAAC -> TTGTGTTAACA
ATTGTTACGTT -> TTGTTACGTTT
ATTTAATGGCC -> TTTAATGGCCT
ATTTAGCTTGT -> TTTAGCTTGTG
ATTTAGGTAGT -> TTTAGGTAGTC
ATTTAGTCGGC -> TTTAGTCGGCC
ATTTATAGGCA -> TTTATAGGCAT
ATTTATGTAGC -> TTTATGTAGCA
ATTTCACCGTG -> TTTCACCGTGT
ATTTCAGGGTT -> TTTCAGGGTTG
ATTTCGTTACC -> TTTCGTTACCC
ATTTTCAGCGT -> TTTTCAGCGTT
CAAAATTCCGG -> AAAATTCCGGA
CAAACTCCGGG -> AAACTCCGGGC
CAAAGAACAAT -> AAAGAACAATT
CAAAGCGTGTT -> AAAGCGTGTTG
CAAAGGTGACG -> AAAGGTGACGT
CAAATAGTCCT -> AAATAGTCCTT
CAAATGACTCT -> AAATGACTCTG
CAACACAAAGG -> AACACAAAGGT
CAACACACCAT -> AACACACCATT
CAACAGACCAT -> AACAGACCATG
CAACATGTGCC -> AACATGTGCCG
CAACGCCTACA -> AACGCCTACAC
CAACGTCTACA -> AACGTCTACAA
CAACTATAGTG -> AACTATAGTGA
CAACTGCACAG -> AACTGCACAGA
CAAGACTGCAC -> AAGACTGCACC
CAAGACTGCCG -> AAGACTGCCGA
CAAGACTGGGG -> AAGACTGGGGT
CAAGCATGCAC -> AAGCATGCACC
CAAGCCGCAAA -> AAGCCGCAAAC
CAAGCGATGAT -> AAGCGATGATT
CAAGCGGGTAT -> AAGCGGGTATT
CAAGGGGAGGT -> AAGGGGAGGTA
CAAGGTCCGGC -> AAGGTCCGGCG
CAAGGTGCGCA -> AAGGTGCGCAG
CAAGTACATTA -> AAGTACATTAC
CAAGTGACGGT -> AAGTGACGGTA
CAATAATAATG -> AATAATAATGG
CAATACGAGGT -> AATACGAGGTA
CAATCACGTTA -> AATCACGTTAG
CAATCTGACGC -> AATCTGACGCT
CAATGTAGCTT -> AATGTAGCTTG
CAATTACAATC -> AATTACAATCT
CAATTGGCACC -> AATTGGCACCT
CAATTTCGTTA -> AATTTCGTTAC
CACAAAGGTGA -> ACAAAGGTGAC
CACAACATGTG -> ACAACATGTGC
CACAATGTAGC -> ACAATGTAGCT
CACACCATTTA -> ACACCATTTAA
CACAGACCAGA -> ACAGACCAGAA
CACAGCGTAAT -> ACAGCGTAATG
CACAGGATCTC -> ACAGGATCTCG
CACAGGCCTTC -> ACAGGCCTTCT
CACAGGGAGAT -> ACAGGGAGATA
CACATATCCCG -> ACATATCCCGC
CACATGCCCAG -> ACATGCCCAGC
CACCAATAATA -> ACCAATAATAA
CACCAGAAACC -> ACCAGAAACCG
CACCAGGAAGT -> ACCAGGAAGTA
CACCAGGTCCA -> ACCAGGTCCAG
CACCATTTAAT -> ACCATTTAATG
CACCCATGCTT -> ACCCATGCTTA
CACCCGCCGCG -> ACCCGCCGCGT
CACCCTTTCAA -> ACCCTTTCAAG
CACCGATCAAG -> ACCGATCAAGA
CACCGGCCAAC -> ACCGGCCAACA
CACCGGGACAA -> ACCGGGACAAA
CACCGGTAACA -> ACCGGTAACAA
CACCGTCCGGG -> ACCGTCCGGGA
CACCGTGTGCA -> ACCGTGTGCAA
CACCTCGACAG -> ACCTCGACAGG
CACCTCGTGTG -> ACCTCGTGTGT
CACCTGCTACT -> ACCTGCTACTG
CACCTGGTGTC -> ACCTGGTGTCC
CACGAGCACTA -> ACGAGCACTAC
CACGAGGTGCC -> ACGAGGTGCCT
CACGCAACAGA -> ACGCAACAGAC
CACGGATATAG -> ACGGATATAGC
CACGGGTCGCC -> ACGGGTCGCCT
CACGGTACTCA -> ACGGTACTCAG
CACGGTATGCA -> ACGGTATGCAG
CACGTCGACGT -> ACGTCGACGTC
CACGTCTCCCG -> ACGTCTCCCGG
CACGTTAGAAA -> ACGTTAGAAAA
CACTAACCGGC -> ACTAACCGGCG
CACTACCCCCG -> ACTACCCCCGT
CACTCACGGTA -> ACTCACGGTAT
CACTCTAAGCA -> ACTCTAAGCAT
CACTCTAGATG -> ACTCTAGATGC
CACTTCGCAAC -> ACTTCGCAACA
CAGAAACCGAG -> AGAAACCGAGG
CAGAACAGATC -> AGAACAGATCC
CAGACCAGAAC -> AGACCAGAACA
CAGACCATGCC -> AGACCATGCCC
CAGACTTCCAA -> AGACTTCCAAG
CAGAGCATCGA -> AGAGCATCGAT
CAGATCCTGAG -> AGATCCTGAGG
CAGATGGCAAC -> AGATGGCAACG
CAGCAGGCAAG -> AGCAGGCAAGC
CAGCATCTTTT -> AGCATCTTTTT
CAGCCAATTGG -> AGCCAATTGGC
CAGCCCGCGTC -> AGCCCGCGTCT
CAGCCTCGCTG -> AGCCTCGCTGG
CAGCGATACAT -> AGCGATACATT
CAGCGCATCTG -> AGCGCATCTGA
CAGCGCTCGCC -> AGCGCTCGCCT
CAGCGTAATGG -> AGCGTAATGGA
CAGCGTTGGCT -> AGCGTTGGCTT
CAGCTGGCAAA -> AGCTGGCAAAG
CAGGAAGACAA -> AGGAAGACAAT
CAGGAAGATAC -> AGGAAGATACA
CAGGAAGTAAG -> AGGAAGTAAGT
CAGGATCTCGG -> AGGATCTCGGT
CAGGCAAGCGG -> AGGCAAGCGGG
CAGGCCAGCGC -> AGGCCAGCGCA
CAGGCCGTATC -> AGGCCGTATCT
CAGGCCTTCTG -> AGGCCTTCTGA
CAGGGAGATAG -> AGGGAGATAGA
CAGGGGAATTC -> AGGGGAATTCG
CAGGGTTGTTG -> AGGGTTGTTGA
CAGGTCCAGTT -> AGGTCCAGTTT
CAGGTTTGCTG -> AGGTTTGCTGA
CAGTAGGGGGC -> AGTAGGGGGCT
CAGTGCCCGTG -> AGTGCCCGTGG
CAGTGGCAAGC -> AGTGGCAAGCG
CAGTGGTAGCT -> AGTGGTAGCTC
CAGTTGTATTT -> AGTTGTATTTA
CAGTTTGTCGT -> AGTTTGTCGTA
CATAAGGGAGG -> ATAAGGGAGGT
CATACGGTTAT -> ATACGGTTATC
CATACTCAGAG -> ATACTCAGAGC
CATAGGCCCAG -> ATAGGCCCAGC
CATAGTTATCT -> ATAGTTATCTA
CATATCACCAA -> ATATCACCAAT
CATATCCCGCA -> ATATCCCGCAA
CATATGGAAAA -> ATATGGAAAAT
CATCACATATC -> ATCACATATCC
CATCATCGTTG -> ATCATCGTTGA
CATCGAAAAGT -> ATCGAAAAGTG
CATCGATCGAG -> ATCGATCGAGA
CATCGGGTGGT -> ATCGGGTGGTA
CATCGTTGACA -> ATCGTTGACAA
CATCTGATCGC -> ATCTGATCGCT
CATCTTTTTTC -> ATCTTTTTTCG
CATGACACAAC -> ATGACACAACA
CATGCAAGCCG -> ATGCAAGCCGC
CATGCACCGGG -> ATGCACCGGGA
CATGCCCAGCC -> ATGCCCAGCCC
CATGCCCTTAA -> ATGCCCTTAAC
CATGCTTAGAT -> ATGCTTAGATC
CATGGAAAGTT -> ATGGAAAGTTA
CATGTGCCGGC -> ATGTGCCGGCA
CATGTGCCTAA -> ATGTGCCTAAA
CATGTTATGGT -> ATGTTATGGTG
CATTACCGCTA -> ATTACCGCTAC
CATTATTCCGA -> ATTATTCCGAA
CATTCACCCTT -> ATTCACCCTTT
CATTGGTCACG -> ATTGGTCACGC
CATTTAATGGC -> ATTTAATGGCC
CATTTATAGGC -> ATTTATAGGCA
CATTTCACCGT -> ATTTCACCGTG
CATTTCAGGGT -> ATTTCAGGGTT
CCAAATGACTC -> CAAATGACTCT
CCAACACAAAG -> CAACACAAAGG
CCAAGGTGCGC -> CAAGGTGCGCA
CCAATAATAAT -> CAATAATAATG
CCAATCACGTT -> CAATCACGTTA
CCAATTGGCAC -> CAATTGGCACC
CCACAGGGAGA -> CACAGGGAGAT
CCACCGATCAA -> CACCGATCAAG
CCACCTGCTAC -> CACCTGCTACT
CCACGAGGTGC -> CACGAGGTGCC
CCACGGGTCGC -> CACGGGTCGCC
CCACTCACGGT -> CACTCACGGTA
CCAGAAACCGA -> CAGAAACCGAG
CCAGAACAGAT -> CAGAACAGATC
CCAGCATCTTT -> CAGCATCTTTT
CCAGCCCGCGT -> CAGCCCGCGTC
CCAGCGCATCT -> CAGCGCATCTG
CCAGCTGGCAA -> CAGCTGGCAAA
CCAGGAAGTAA -> CAGGAAGTAAG
CCAGGTCCAGT -> CAGGTCCAGTT
CCAGTTGTATT -> CAGTTGTATTT
CCAGTTTGTCG -> CAGTTTGTCGT
CCATATCACCA -> CATATCACCAA
CCATCATCGTT -> CATCATCGTTG
CCATCGAAAAG -> CATCGAAAAGT
CCATGCCCTTA -> CATGCCCTTAA
CCATGCTTAGA -> CATGCTTAGAT
CCATTATTCCG -> CATTATTCCGA
CCATTTAATGG -> CATTTAATGGC
CCATTTATAGG -> CATTTATAGGC
CCATTTCAGGG -> CATTTCAGGGT
CCCAATCACGT -> CCAATCACGTT
CCCACCTGCTA -> CCACCTGCTAC
CCCACGAGGTG -> CCACGAGGTGC
CCCAGCATCTT -> CCAGCATCTTT
CCCAGCCCGCG -> CCAGCCCGCGT
CCCAGTTGTAT -> CCAGTTGTATT
CCCATATCACC -> CCATATCACCA
CCCATGCTTAG -> CCATGCTTAGA
CCCATTTATAG -> CCATTTATAGG
CCCCATTTATA -> CCCATTTATAG
CCCCCATTTAT -> CCCCATTTATA
CCCCCGTGCCG -> CCCCGTGCCGG
CCCCGATCTCC -> CCCGATCTCCA
CCCCGGCGTCT -> CCCGGCGTCTC
CCCCGTACTAT -> CCCGTACTATA
CCCCGTGCCGG -> CCCGTGCCGGC
CCCCTATTGCG -> CCCTATTGCGT
CCCGATCTCCA -> CCGATCTCCAC
CCCGCAAGACT -> CCGCAAGACTG
CCCGCCGCGTC -> CCGCCGCGTCT
CCCGCGTCTCC -> CCGCGTCTCCA
CCCGGATACCC -> CCGGATACCCA
CCCGGCGTCTC -> CCGGCGTCTCC
CCCGTACTATA -> CCGTACTATAT
CCCGTGCCGGC -> CCGTGCCGGCA
CCCGTGGGATA -> CCGTGGGATAA
CCCGTTTGGCG -> CCGTTTGGCGT
CCCTACCGTTA -> CCTACCGTTAT
CCCTATTGCGT -> CCTATTGCGTG
CCCTTAACACT -> CCTTAACACTT
CCCTTTCAAGG -> CCTTTCAAGGG
CCGAACATGCA -> CGAACATGCAA
CCGAAGGATCA -> CGAAGGATCAG
CCGACACAGGA -> CGACACAGGAT
CCGACACGAGC -> CGACACGAGCA
CCGACTCCCCG -> CGACTCCCCGT
CCGAGATAGCA -> CGAGATAGCAG
CCGAGGACAGT -> CGAGGACAGTG
CCGAGGGTGAA -> CGAGGGTGAAA
CCGATCAAGAC -> CGATCAAGACT
CCGATCTCCAC -> CGATCTCCACC
CCGCAAACTCC -> CGCAAACTCCG
CCGCAAGACTG -> CGCAAGACTGC
CCGCCCCCATT -> CGCCCCCATTT
CCGCCGCGTCT -> CGCCGCGTCTA
CCGCGTCTACA -> CGCGTCTACAT
CCGCGTCTCCA -> CGCGTCTCCAT
CCGCTACGTAT -> CGCTACGTATT
CCGGAGTGACT -> CGGAGTGACTC
CCGGATACCCA -> CGGATACCCAC
CCGGATATCAT -> CGGATATCATA
CCGGCAGATGG -> CGGCAGATGGC
CCGGCAGGGGA -> CGGCAGGGGAA
CCGGCCAACAC -> CGGCCAACACA
CCGGCGAGCTG -> CGGCGAGCTGT
CCGGCGATAAA -> CGGCGATAAAC
CCGGCGTCTCC -> CGGCGTCTCCG
CCGGGACAAAA -> CGGGACAAAAT
CCGGGACCCAT -> CGGGACCCATA
CCGGGACTCAT -> CGGGACTCATG
CCGGGCGCTAA -> CGGGCGCTAAT
CCGGGCTAACG -> CGGGCTAACGC
CCGGGTCCTAC -> CGGGTCCTACG
CCGGTAACAAG -> CGGTAACAAGT
CCGTACTATAT -> CGTACTATATC
CCGTATCTGGT -> CGTATCTGGTT
CCGTCCGGGAC -> CGTCCGGGACC
CCGTGCCGGCA -> CGTGCCGGCAG
CCGTGGGATAA -> CGTGGGATAAT
CCGTGTGCAAC -> CGTGTGCAACT
CCGTTATAGAT -> CGTTATAGATG
CCGTTCCGGGA -> CGTTCCGGGAC
CCGTTTGGCGT -> CGTTTGGCGTG
CCTAAATATGC -> CTAAATATGCA
CCTAAGGACGT -> CTAAGGACGTC
CCTACACCCGC -> CTACACCCGCC
CCTACCGTTAT -> CTACCGTTATA
CCTACGACACG -> CTACGACACGG
CCTAGCCGGGC -> CTAGCCGGGCG
CCTATTGCGTG -> CTATTGCGTGT
CCTCACCAGGT -> CTCACCAGGTC
CCTCCTCGACG -> CTCCTCGACGC
CCTCGACAGGT -> CTCGACAGGTT
CCTCGACGCAG -> CTCGACGCAGT
CCTCGCCGGAG -> CTCGCCGGAGT
CCTCGCTGGGA -> CTCGCTGGGAG
CCTCGTGCGCT -> CTCGTGCGCTT
CCTCGTGTGTT -> CTCGTGTGTTA
CCTGAGGGGTC -> CTGAGGGGTCA
CCTGCAGCAGG -> CTGCAGCAGGC
CCTGCTACTGA -> CTGCTACTGAG
CCTGGACGCCG -> CTGGACGCCGA
CCTGGCGAGGT -> CTGGCGAGGTA
CCTGGTGTCCA -> CTGGTGTCCAC
CCTGTCCGAGG -> CTGTCCGAGGG
CCTTAACACTT -> CTTAACACTTC
CCTTACTATTT -> CTTACTATTTA
CCTTCTGATGC -> CTTCTGATGCT
CCTTTCAAGGG -> CTTTCAAGGGG
CCTTTGCAGAC -> CTTTGCAGACT
CGAAAAGTGCT -> GAAAAGTGCTA
CGAACATGCAA -> GAACATGCAAG
CGAAGGATCAG -> GAAGGATCAGG
CGACAAGGTCC -> GACAAGGTCCG
CGACACAGGAT -> GACACAGGATC
CGACACCTCGT -> GACACCTCGTG
CGACACGAGCA -> GACACGAGCAC
CGACACGGTAC -> GACACGGTACT
CGACAGGTTTG -> GACAGGTTTGC
CGACGCAGTGG -> GACGCAGTGGT
CGACGTCTCTA -> GACGTCTCTAA
CGACTCCCCGT -> GACTCCCCGTA
CGAGAGTGTGC -> GAGAGTGTGCT
CGAGATAGCAG -> GAGATAGCAGC
CGAGCACTACC -> GAGCACTACCC
CGAGCTGTTCA -> GAGCTGTTCAG
CGAGGACAGTG -> GAGGACAGTGG
CGAGGGTGAAA -> GAGGGTGAAAA
CGAGGTACCTG -> GAGGTACCTGT
CGAGGTAGCCC -> GAGGTAGCCCC
CGAGGTGCCTT -> GAGGTGCCTTT
CGATAAACTGG -> GATAAACTGGA
CGATACATTCA -> GATACATTCAC
CGATCAAGACT -> GATCAAGACTG
CGATCGAGAGT -> GATCGAGAGTG
CGATCTCCACC -> GATCTCCACCG
CGATGATTTAG -> GATGATTTAGC
CGCAAACTCCG -> GCAAACTCCGG
CGCAACACACC -> GCAACACACCA
CGCAACAGACC -> GCAACAGACCA
CGCAAGACTGC -> GCAAGACTGCA
CGCAGGAAGAC -> GCAGGAAGACA
CGCAGTGGTAG -> GCAGTGGTAGC
CGCATCTGATC -> GCATCTGATCG
CGCATGTGCCT -> GCATGTGCCTA
CGCCCAATCAC -> GCCCAATCACG
CGCCCCCATTT -> GCCCCCATTTA
CGCCGACTCCC -> GCCGACTCCCC
CGCCGCGTCTA -> GCCGCGTCTAC
CGCCGGAGTGA -> GCCGGAGTGAC
CGCCTACACCC -> GCCTACACCCG
CGCCTCGTGCG -> GCCTCGTGCGC
CGCCTGGACGC -> GCCTGGACGCC
CGCCTGGCGAG -> GCCTGGCGAGG
CGCGGCTTACG -> GCGGCTTACGT
CGCGGTATCAA -> GCGGTATCAAG
CGCGTCTACAT -> GCGTCTACATA
CGCGTCTCCAT -> GCGTCTCCATT
CGCTAATTACA -> GCTAATTACAG
CGCTACGTATT -> GCTACGTATTG
CGCTCACCTCG -> GCTCACCTCGA
CGCTCGCCTGG -> GCTCGCCTGGA
CGCTGAATACT -> GCTGAATACTC
CGCTGATAGGT -> GCTGATAGGTG
CGCTGGGAGAT -> GCTGGGAGATA
CGCTTGAAGCT -> GCTTGAAGCTT
CGGAGTGACTC -> GGAGTGACTCT
CGGATACCCAC -> GGATACCCACC
CGGATATAGCC -> GGATATAGCCT
CGGATATCATA -> GGATATCATAC
CGGCAAGACTG -> GGCAAGACTGG
CGGCAGATGGC -> GGCAGATGGCA
CGGCAGGGGAA -> GGCAGGGGAAT
CGGCCAACACA -> GGCCAACACAA
CGGCCCACGAG -> GGCCCACGAGG
CGGCGAGCTGT -> GGCGAGCTGTT
CGGCGATAAAC -> GGCGATAAACT
CGGCGTCTCCG -> GGCGTCTCCGA
CGGCTTACGTG -> GGCTTACGTGG
CGGGACAAAAT -> GGGACAAAATT
CGGGACCCATA -> GGGACCCATAT
CGGGACTCATG -> GGGACTCATGT
CGGGAGGCAGG -> GGGAGGCAGGC
CGGGCGCTAAT -> GGGCGCTAATT
CGGGCTAACGC -> GGGCTAACGCC
CGGGTATTTAT -> GGGTATTTATG
CGGGTCCGACA -> GGGTCCGACAC
CGGGTCCTACG -> GGGTCCTACGA
CGGGTCGCCTC -> GGGTCGCCTCG
CGGGTGGTATT -> GGGTGGTATTT
CGGTAACAAGT -> GGTAACAAGTG
CGGTACACATG -> GGTACACATGC
CGGTACTCAGT -> GGTACTCAGTA
CGGTATCAAGC -> GGTATCAAGCA
CGGTATGCAGC -> GGTATGCAGCC
CGGTTATCTTT -> GGTTATCTTTG
CGGTTCCGAAG -> GGTTCCGAAGG
CGTAATGGAAC -> GTAATGGAACC
CGTACGGGAGG -> GTACGGGAGGC
CGTACTATATC -> GTACTATATCA
CGTAGACCGGG -> GTAGACCGGGT
CGTATCTGGTT -> GTATCTGGTTA
CGTATTGTCTC -> GTATTGTCTCC
CGTCACCAGAA -> GTCACCAGAAA
CGTCCGGGACC -> GTCCGGGACCC
CGTCGACGTCT -> GTCGACGTCTC
CGTCGCTCACC -> GTCGCTCACCT
CGTCTACAAAG -> GTCTACAAAGA
CGTCTACATAG -> GTCTACATAGG
CGTCTCCATTA -> GTCTCCATTAT
CGTCTCCCGGA -> GTCTCCCGGAT
CGTCTCCGAGA -> GTCTCCGAGAT
CGTCTCTAATG -> GTCTCTAATGT
CGTGCCGGCAG -> GTGCCGGCAGG
CGTGCGCTTGA -> GTGCGCTTGAA
CGTGGCAAATA -> GTGGCAAATAG
CGTGGGATAAT -> GTGGGATAATA
CGTGTAATTGG -> GTGTAATTGGA
CGTGTAGAACG -> GTGTAGAACGG
CGTGTGCAACT -> GTGTGCAACTA
CGTGTGTTACT -> GTGTGTTACTA
CGTGTTGACAC -> GTGTTGACACT
CGTTACCCTAC -> GTTACCCTACC
CGTTAGAAAAC -> GTTAGAAAACT
CGTTATAGATG -> GTTATAGATGC
CGTTCCGGGAC -> GTTCCGGGACT
CGTTGACAAGT -> GTTGACAAGTA
CGTTGGCTTGT -> GTTGGCTTGTA
CGTTTATCCAA -> GTTTATCCAAA
CGTTTGGCGTG -> GTTTGGCGTGT
CGTTTGTAAAG -> GTTTGTAAAGA
CTAAATAAGAG -> TAAATAAGAGA
CTAAATATGCA -> TAAATATGCAT
CTAACAATACG -> TAACAATACGA
CTAACCGGCGA -> TAACCGGCGAG
CTAACGCCTGG -> TAACGCCTGGC
CTAAGCATACT -> TAAGCATACTC
CTAAGGACGTC -> TAAGGACGTCA
CTAAGTCTAGG -> TAAGTCTAGGC
CTAATATAAGA -> TAATATAAGAG
CTAATGCGCGG -> TAATGCGCGGT
CTAATGTAATA -> TAATGTAATAC
CTAATTACAGG -> TAATTACAGGC
CTACAAAGAAC -> TACAAAGAACA
CTACACCCGCC -> TACACCCGCCG
CTACATAGGCC -> TACATAGGCCC
CTACCCCCGTG -> TACCCCCGTGC
CTACCGTTATA -> TACCGTTATAG
CTACCTCACCA -> TACCTCACCAG
CTACGACACGG -> TACGACACGGT
CTACGTATTGT -> TACGTATTGTC
CTACTCTCATA -> TACTCTCATAG
CTACTGAGACC -> TACTGAGACCG
CTAGAGCCCCG -> TAGAGCCCCGA
CTAGATGCCCG -> TAGATGCCCGT
CTAGCCGGGCG -> TAGCCGGGCGC
CTAGGCCATCA -> TAGGCCATCAT
CTATAGTGAGA -> TATAGTGAGAA
CTATATCATCG -> TATATCATCGG
CTATGCCTAGC -> TATGCCTAGCC
CTATGTTCAAC -> TATGTTCAACG
CTATTGCGTGT -> TATTGCGTGTA
CTATTTAGGTA -> TATTTAGGTAG
CTCACAGCGTA -> TCACAGCGTAA
CTCACCAGGTC -> TCACCAGGTCC
CTCACCTCGAC -> TCACCTCGACA
CTCACGGTATG -> TCACGGTATGC
CTCAGAGCATC -> TCAGAGCATCG
CTCAGTAGGGG -> TCAGTAGGGGG
CTCATAGTTAT -> TCATAGTTATC
CTCATGTTATG -> TCATGTTATGG
CTCCACCGATC -> TCCACCGATCA
CTCCACGGGTC -> TCCACGGGTCG
CTCCACTCACG -> TCCACTCACGG
CTCCATTATTC -> TCCATTATTCC
CTCCCCGGCGT -> TCCCCGGCGTC
CTCCCCGTACT -> TCCCCGTACTA
CTCCCGGATAC -> TCCCGGATACC
CTCCGAGATAG -> TCCGAGATAGC
CTCCGGGCTAA -> TCCGGGCTAAC
CTCCTCGACGC -> TCCTCGACGCA
CTCGACAGGTT -> TCGACAGGTTT
CTCGACGCAGT -> TCGACGCAGTG
CTCGCCCAATC -> TCGCCCAATCA
CTCGCCGGAGT -> TCGCCGGAGTG
CTCGCCTGGAC -> TCGCCTGGACG
CTCGCTGGGAG -> TCGCTGGGAGA
CTCGGTTCCGA -> TCGGTTCCGAA
CTCGTGCGCTT -> TCGTGCGCTTG
CTCGTGTGTTA -> TCGTGTGTTAC
CTCGTTTGTAA -> TCGTTTGTAAA
CTCTAAGCATA -> TCTAAGCATAC
CTCTAATGTAA -> TCTAATGTAAT
CTCTACCTCAC -> TCTACCTCACC
CTCTAGATGCC -> TCTAGATGCCC
CTCTCATAGTT -> TCTCATAGTTA
CTCTGGCACCC -> TCTGGCACCCA
CTCTTAACACG -> TCTTAACACGT
CTGAATACTCT -> TGAATACTCTT
CTGAATGCTAA -> TGAATGCTAAC
CTGACGCTGAA -> TGACGCTGAAT
CTGAGACCGTT -> TGAGACCGTTC
CTGAGGGGTCA -> TGAGGGGTCAC
CTGATAGGTGG -> TGATAGGTGGA
CTGATCGCTGA -> TGATCGCTGAT
CTGATGCTAAT -> TGATGCTAATG
CTGCACAGACC -> TGCACAGACCA
CTGCACCGGCC -> TGCACCGGCCA
CTGCAGCAGGC -> TGCAGCAGGCA
CTGCCGACACA -> TGCCGACACAG
CTGCTACTGAG -> TGCTACTGAGA
CTGCTTTTACA -> TGCTTTTACAT
CTGGACCCAGT -> TGGACCCAGTT
CTGGACGCCGA -> TGGACGCCGAC
CTGGCAAAGCG -> TGGCAAAGCGT
CTGGCACCCAT -> TGGCACCCATG
CTGGCGAGGTA -> TGGCGAGGTAG
CTGGGAGATAT -> TGGGAGATATA
CTGGGGTTGTG -> TGGGGTTGTGA
CTGGTGTCCAC -> TGGTGTCCACA
CTGGTTAGCAC -> TGGTTAGCACG
CTGTCCGAGGG -> TGTCCGAGGGT
CTGTTCAGTGC -> TGTTCAGTGCC
CTTAACACGTC -> TTAACACGTCT
CTTAACACTTC -> TTAACACTTCG
CTTACCAGCTG -> TTACCAGCTGG
CTTACGTGGCA -> TTACGTGGCAA
CTTACTATTTA -> TTACTATTTAG
CTTAGATCACC -> TTAGATCACCA
CTTCCAAGGTG -> TTCCAAGGTGC
CTTCGCAACAC -> TTCGCAACACA
CTTCTCCACGG -> TTCTCCACGGG
CTTCTCGTTTG -> TTCTCGTTTGT
CTTCTGATGCT -> TTCTGATGCTA
CTTGAAGCTTA -> TTGAAGCTTAC
CTTGCTACTCT -> TTGCTACTCTC
CTTGTAACGCA -> TTGTAACGCAT
CTTGTGAATCT -> TTGTGAATCTG
CTTTCAAGGGG -> TTTCAAGGGGA
CTTTGATTCGC -> TTTGATTCGCG
CTTTGCAGACT -> TTTGCAGACTT
CTTTTACATAA -> TTTTACATAAG
CTTTTTTCGGG -> TTTTTTCGGGT
GAAAACACAAT -> AAAACACAATG
GAAAACTTCTC -> AAAACTTCTCC
GAAAAGTGCTA -> AAAAGTGCTAT
GAAAATGTAGA -> AAAATGTAGAT
GAAACCGAGGA -> AAACCGAGGAC
GAAAGTTATTG -> AAAGTTATTGT
GAACAATTACA -> AACAATTACAA
GAACAGATCCT -> AACAGATCCTG
GAACATGCAAG -> AACATGCAAGC
GAACATGGAAA -> AACATGGAAAG
GAACCATCGAA -> AACCATCGAAA
GAACGGCAAGA -> AACGGCAAGAC
GAAGACAATTT -> AAGACAATTTC
GAAGATACACG -> AAGATACACGT
GAAGCTTACCA -> AAGCTTACCAG
GAAGGATCAGG -> AAGGATCAGGA
GAAGTAAGTGA -> AAGTAAGTGAC
GAATAATAATG -> AATAATAATGG
GAATACTCTTA -> AATACTCTTAA
GAATCTGGACC -> AATCTGGACCC
GAATGCTAACA -> AATGCTAACAA
GAATTCGACAC -> AATTCGACACC
GACAAAATTCC -> ACAAAATTCCG
GACAAGGTCCG -> ACAAGGTCCGG
GACAAGTACAT -> ACAAGTACATT
GACAATTTCGT -> ACAATTTCGTT
GACACAACATG -> ACACAACATGT
GACACAGGATC -> ACACAGGATCT
GACACAGGCCT -> ACACAGGCCTT
GACACCGTCCG -> ACACCGTCCGG
GACACCTCGTG -> ACACCTCGTGT
GACACGAGCAC -> ACACGAGCACT
GACACGGTACT -> ACACGGTACTC
GACACTCTAAG -> ACACTCTAAGC
GACAGCGCTCG -> ACAGCGCTCGC
GACAGGTTTGC -> ACAGGTTTGCT
GACAGTGGCAA -> ACAGTGGCAAG
GACATGACACA -> ACATGACACAA
GACCAGAACAG -> ACCAGAACAGA
GACCATGCCCT -> ACCATGCCCTT
GACCCAGTTGT -> ACCCAGTTGTA
GACCCATATCA -> ACCCATATCAC
GACCGCCCCCA -> ACCGCCCCCAT
GACCGGGTCCT -> ACCGGGTCCTA
GACCGTTCCGG -> ACCGTTCCGGG
GACGCAGTGGT -> ACGCAGTGGTA
GACGCCGACTC -> ACGCCGACTCC
GACGCTGAATA -> ACGCTGAATAC
GACGGTACACA -> ACGGTACACAT
GACGTACGGGA -> ACGTACGGGAG
GACGTCACCAG -> ACGTCACCAGA
GACGTCTCTAA -> ACGTCTCTAAT
GACTCATGTTA -> ACTCATGTTAT
GACTCCCCGGC -> ACTCCCCGGCG
GACTCCCCGTA -> ACTCCCCGTAC
GACTCTACCTC -> ACTCTACCTCA
GACTCTGGCAC -> ACTCTGGCACC
GACTGCACCGG -> ACTGCACCGGC
GACTGCCGACA -> ACTGCCGACAC
GACTGGGGTTG -> ACTGGGGTTGT
GACTTCCAAGG -> ACTTCCAAGGT
GAGAACATGGA -> AGAACATGGAA
GAGACCGCCCC -> AGACCGCCCCC
GAGACCGTTCC -> AGACCGTTCCG
GAGAGTGTGCT -> AGAGTGTGCTA
GAGATAGAGGC -> AGATAGAGGCC
GAGATAGCAGC -> AGATAGCAGCC
GAGATATATCA -> AGATATATCAC
GAGCACTACCC -> AGCACTACCCC
GAGCATCGATC -> AGCATCGATCG
GAGCCCCGATC -> AGCCCCGATCT
GAGCGTCGCTC -> AGCGTCGCTCA
GAGCTGTTCAG -> AGCTGTTCAGT
GAGGACAGTGG -> AGGACAGTGGC
GAGGCAGGCCG -> AGGCAGGCCGT
GAGGCCTAAGG -> AGGCCTAAGGA
GAGGGGTCACT -> AGGGGTCACTA
GAGGGTGAAAA -> AGGGTGAAAAC
GAGGTACCTGT -> AGGTACCTGTC
GAGGTAGCCCC -> AGGTAGCCCCT
GAGGTATAGAT -> AGGTATAGATA
GAGGTGCCTTT -> AGGTGCCTTTG
GAGGTTCTAAG -> AGGTTCTAAGT
GAGTCTGCTTT -> AGTCTGCTTTT
GAGTGACTCTA -> AGTGACTCTAC
GAGTGTGCTAG -> AGTGTGCTAGA
GATAAACTGGA -> ATAAACTGGAC
GATAATAAGAT -> ATAATAAGATT
GATAATTGTGT -> ATAATTGTGTT
GATACACGTCG -> ATACACGTCGA
GATACATTCAC -> ATACATTCACC
GATACCCACCT -> ATACCCACCTG
GATACTCACAG -> ATACTCACAGC
GATAGAGGCCT -> ATAGAGGCCTA
GATAGCAGCCA -> ATAGCAGCCAA
GATAGCGACAA -> ATAGCGACAAG
GATAGGTGGAC -> ATAGGTGGACT
GATATAGCCTC -> ATATAGCCTCC
GATATATCACC -> ATATATCACCG
GATATCATACG -> ATATCATACGG
GATCAAGACTG -> ATCAAGACTGC
GATCACCAGGA -> ATCACCAGGAA
GATCAGGAAGA -> ATCAGGAAGAT
GATCCTGAGGG -> ATCCTGAGGGG
GATCGAGAGTG -> ATCGAGAGTGT
GATCGCTGATA -> ATCGCTGATAG
GATCTCCACCG -> ATCTCCACCGA
GATCTCGGTTC -> ATCTCGGTTCC
GATGATTTAGC -> ATGATTTAGCT
GATGCATATGG -> ATGCATATGGA
GATGCCCGTTT -> ATGCCCGTTTG
GATGCTAATGC -> ATGCTAATGCG
GATGGCAACGT -> ATGGCAACGTC
GATTCGCGGCT -> ATTCGCGGCTT
GATTGGACATG -> ATTGGACATGA
GATTTAGCTTG -> ATTTAGCTTGT
GCAAACTCCGG -> CAAACTCCGGG
GCAAAGCGTGT -> CAAAGCGTGTT
GCAAATAGTCC -> CAAATAGTCCT
GCAACACACCA -> CAACACACCAT
GCAACAGACCA -> CAACAGACCAT
GCAACGTCTAC -> CAACGTCTACA
GCAACTATAGT -> CAACTATAGTG
GCAAGACTGCA -> CAAGACTGCAC
GCAAGACTGGG -> CAAGACTGGGG
GCAAGCCGCAA -> CAAGCCGCAAA
GCAAGCGATGA -> CAAGCGATGAT
GCAAGCGGGTA -> CAAGCGGGTAT
GCACAGACCAG -> CACAGACCAGA
GCACCCATGCT -> CACCCATGCTT
GCACCGGCCAA -> CACCGGCCAAC
GCACCGGGACA -> CACCGGGACAA
GCACCTGGTGT -> CACCTGGTGTC
GCACGGATATA -> CACGGATATAG
GCACTACCCCC -> CACTACCCCCG
GCACTCTAGAT -> CACTCTAGATG
GCAGACTTCCA -> CAGACTTCCAA
GCAGATGGCAA -> CAGATGGCAAC
GCAGCAGGCAA -> CAGCAGGCAAG
GCAGCCAATTG -> CAGCCAATTGG
GCAGCCTCGCT -> CAGCCTCGCTG
GCAGGAAGACA -> CAGGAAGACAA
GCAGGCAAGCG -> CAGGCAAGCGG
GCAGGCCGTAT -> CAGGCCGTATC
GCAGGGGAATT -> CAGGGGAATTC
GCAGTGGTAGC -> CAGTGGTAGCT
GCATACTCAGA -> CATACTCAGAG
GCATATGGAAA -> CATATGGAAAA
GCATCACATAT -> CATCACATATC
GCATCGATCGA -> CATCGATCGAG
GCATCTGATCG -> CATCTGATCGC
GCATCTTTTTT -> CATCTTTTTTC
GCATGCACCGG -> CATGCACCGGG
GCATGTGCCTA -> CATGTGCCTAA
GCATTGGTCAC -> CATTGGTCACG
GCATTTCACCG -> CATTTCACCGT
GCCAACACAAA -> CCAACACAAAG
GCCAATTGGCA -> CCAATTGGCAC
GCCAGCGCATC -> CCAGCGCATCT
GCCATCATCGT -> CCATCATCGTT
GCCCAATCACG -> CCCAATCACGT
GCCCACGAGGT -> CCCACGAGGTG
GCCCAGCATCT -> CCCAGCATCTT
GCCCAGCCCGC -> CCCAGCCCGCG
GCCCCCATTTA -> CCCCCATTTAT
GCCCCGATCTC -> CCCCGATCTCC
GCCCCTATTGC -> CCCCTATTGCG
GCCCGCGTCTC -> CCCGCGTCTCC
GCCCGTGGGAT -> CCCGTGGGATA
GCCCGTTTGGC -> CCCGTTTGGCG
GCCCTTAACAC -> CCCTTAACACT
GCCGACACAGG -> CCGACACAGGA
GCCGACTCCCC -> CCGACTCCCCG
GCCGCAAACTC -> CCGCAAACTCC
GCCGCGTCTAC -> CCGCGTCTACA
GCCGGAGTGAC -> CCGGAGTGACT
GCCGGCAGATG -> CCGGCAGATGG
GCCGGCAGGGG -> CCGGCAGGGGA
GCCGGGCGCTA -> CCGGGCGCTAA
GCCGTATCTGG -> CCGTATCTGGT
GCCTAAATATG -> CCTAAATATGC
GCCTAAGGACG -> CCTAAGGACGT
GCCTACACCCG -> CCTACACCCGC
GCCTAGCCGGG -> CCTAGCCGGGC
GCCTCCTCGAC -> CCTCCTCGACG
GCCTCGCCGGA -> CCTCGCCGGAG
GCCTCGCTGGG -> CCTCGCTGGGA
GCCTCGTGCGC -> CCTCGTGCGCT
GCCTGGACGCC -> CCTGGACGCCG
GCCTGGCGAGG -> CCTGGCGAGGT
GCCTTCTGATG -> CCTTCTGATGC
GCCTTTGCAGA -> CCTTTGCAGAC
GCGACAAGGTC -> CGACAAGGTCC
GCGAGCTGTTC -> CGAGCTGTTCA
GCGAGGTAGCC -> CGAGGTAGCCC
GCGATAAACTG -> CGATAAACTGG
GCGATACATTC -> CGATACATTCA
GCGATGATTTA -> CGATGATTTAG
GCGCAGGAAGA -> CGCAGGAAGAC
GCGCATCTGAT -> CGCATCTGATC
GCGCGGTATCA -> CGCGGTATCAA
GCGCTAATTAC -> CGCTAATTACA
GCGCTCGCCTG -> CGCTCGCCTGG
GCGCTTGAAGC -> CGCTTGAAGCT
GCGGCTTACGT -> CGGCTTACGTG
GCGGGTATTTA -> CGGGTATTTAT
GCGGTATCAAG -> CGGTATCAAGC
GCGTAATGGAA -> CGTAATGGAAC
GCGTCGCTCAC -> CGTCGCTCACC
GCGTCTACATA -> CGTCTACATAG
GCGTCTCCATT -> CGTCTCCATTA
GCGTCTCCGAG -> CGTCTCCGAGA
GCGTGTAATTG -> CGTGTAATTGG
GCGTGTAGAAC -> CGTGTAGAACG
GCGTGTTGACA -> CGTGTTGACAC
GCGTTGGCTTG -> CGTTGGCTTGT
GCTAACAATAC -> CTAACAATACG
GCTAACGCCTG -> CTAACGCCTGG
GCTAATGCGCG -> CTAATGCGCGG
GCTAATTACAG -> CTAATTACAGG
GCTACGTATTG -> CTACGTATTGT
GCTACTCTCAT -> CTACTCTCATA
GCTACTGAGAC -> CTACTGAGACC
GCTAGAGCCCC -> CTAGAGCCCCG
GCTATGCCTAG -> CTATGCCTAGC
GCTATGTTCAA -> CTATGTTCAAC
GCTCACCTCGA -> CTCACCTCGAC
GCTCGCCCAAT -> CTCGCCCAATC
GCTCGCCTGGA -> CTCGCCTGGAC
GCTGAATACTC -> CTGAATACTCT
GCTGAATGCTA -> CTGAATGCTAA
GCTGATAGGTG -> CTGATAGGTGG
GCTGGCAAAGC -> CTGGCAAAGCG
GCTGGGAGATA -> CTGGGAGATAT
GCTGTTCAGTG -> CTGTTCAGTGC
GCTTACCAGCT -> CTTACCAGCTG
GCTTACGTGGC -> CTTACGTGGCA
GCTTAGATCAC -> CTTAGATCACC
GCTTCTCGTTT -> CTTCTCGTTTG
GCTTGAAGCTT -> CTTGAAGCTTA
GCTTGCTACTC -> CTTGCTACTCT
GCTTGTAACGC -> CTTGTAACGCA
GCTTGTGAATC -> CTTGTGAATCT
GCTTTTACATA -> CTTTTACATAA
GGAAAATGTAG -> GAAAATGTAGA
GGAAAGTTATT -> GAAAGTTATTG
GGAACCATCGA -> GAACCATCGAA
GGAAGACAATT -> GAAGACAATTT
GGAAGATACAC -> GAAGATACACG
GGAAGTAAGTG -> GAAGTAAGTGA
GGAATTCGACA -> GAATTCGACAC
GGACAAAATTC -> GACAAAATTCC
GGACACCGTCC -> GACACCGTCCG
GGACAGTGGCA -> GACAGTGGCAA
GGACATGACAC -> GACATGACACA
GGACCCAGTTG -> GACCCAGTTGT
GGACCCATATC -> GACCCATATCA
GGACGCCGACT -> GACGCCGACTC
GGACGTCACCA -> GACGTCACCAG
GGACTCATGTT -> GACTCATGTTA
GGACTCCCCGG -> GACTCCCCGGC
GGAGATAGAGG -> GAGATAGAGGC
GGAGATATATC -> GAGATATATCA
GGAGGCAGGCC -> GAGGCAGGCCG
GGAGGTATAGA -> GAGGTATAGAT
GGAGGTTCTAA -> GAGGTTCTAAG
GGAGTGACTCT -> GAGTGACTCTA
GGATAATAAGA -> GATAATAAGAT
GGATACCCACC -> GATACCCACCT
GGATATAGCCT -> GATATAGCCTC
GGATATCATAC -> GATATCATACG
GGATCAGGAAG -> GATCAGGAAGA
GGATCTCGGTT -> GATCTCGGTTC
GGCAAAGCGTG -> GCAAAGCGTGT
GGCAAATAGTC -> GCAAATAGTCC
GGCAACGTCTA -> GCAACGTCTAC
GGCAAGACTGG -> GCAAGACTGGG
GGCAAGCGATG -> GCAAGCGATGA
GGCAAGCGGGT -> GCAAGCGGGTA
GGCACCCATGC -> GCACCCATGCT
GGCACCTGGTG -> GCACCTGGTGT
GGCAGATGGCA -> GCAGATGGCAA
GGCAGGCCGTA -> GCAGGCCGTAT
GGCAGGGGAAT -> GCAGGGGAATT
GGCATTTCACC -> GCATTTCACCG
GGCCAACACAA -> GCCAACACAAA
GGCCAGCGCAT -> GCCAGCGCATC
GGCCATCATCG -> GCCATCATCGT
GGCCCACGAGG -> GCCCACGAGGT
GGCCCAGCATC -> GCCCAGCATCT
GGCCGTATCTG -> GCCGTATCTGG
GGCCTAAGGAC -> GCCTAAGGACG
GGCCTCGCCGG -> GCCTCGCCGGA
GGCCTTCTGAT -> GCCTTCTGATG
GGCGAGCTGTT -> GCGAGCTGTTC
GGCGAGGTAGC -> GCGAGGTAGCC
GGCGATAAACT -> GCGATAAACTG
GGCGCTAATTA -> GCGCTAATTAC
GGCGTCTCCGA -> GCGTCTCCGAG
GGCGTGTAGAA -> GCGTGTAGAAC
GGCTAACGCCT -> GCTAACGCCTG
GGCTATGCCTA -> GCTATGCCTAG
GGCTTACGTGG -> GCTTACGTGGC
GGCTTCTCGTT -> GCTTCTCGTTT
GGCTTGTAACG -> GCTTGTAACGC
GGGAATTCGAC -> GGAATTCGACA
GGGACAAAATT -> GGACAAAATTC
GGGACCCATAT -> GGACCCATATC
GGGACTCATGT -> GGACTCATGTT
GGGAGATAGAG -> GGAGATAGAGG
GGGAGATATAT -> GGAGATATATC
GGGAGGCAGGC -> GGAGGCAGGCC
GGGAGGTATAG -> GGAGGTATAGA
GGGAGGTTCTA -> GGAGGTTCTAA
GGGATAATAAG -> GGATAATAAGA
GGGCGCTAATT -> GGCGCTAATTA
GGGCTAACGCC -> GGCTAACGCCT
GGGCTATGCCT -> GGCTATGCCTA
GGGGAATTCGA -> GGGAATTCGAC
GGGGAGGTATA -> GGGAGGTATAG
GGGGCTATGCC -> GGGCTATGCCT
GGGGGCTATGC -> GGGGCTATGCC
GGGGTCACTAA -> GGGTCACTAAC
GGGGTTGTGAA -> GGGTTGTGAAT
GGGTATTTATG -> GGTATTTATGT
GGGTCACTAAC -> GGTCACTAACC
GGGTCCGACAC -> GGTCCGACACG
GGGTCCTACGA -> GGTCCTACGAC
GGGTCGCCTCG -> GGTCGCCTCGT
GGGTGAAAACA -> GGTGAAAACAC
GGGTGGTATTT -> GGTGGTATTTT
GGGTTGTGAAT -> GGTTGTGAATA
GGGTTGTTGAT -> GGTTGTTGATA
GGTAACAAGTG -> GTAACAAGTGA
GGTACACATGC -> GTACACATGCC
GGTACCTGCAG -> GTACCTGCAGC
GGTACCTGTCC -> GTACCTGTCCG
GGTACTCAGTA -> GTACTCAGTAG
GGTAGCCCCTA -> GTAGCCCCTAT
GGTAGCTCGCC -> GTAGCTCGCCC
GGTAGTCAGCG -> GTAGTCAGCGA
GGTATAGATAA -> GTATAGATAAT
GGTATCAAGCA -> GTATCAAGCAT
GGTATGCAGCC -> GTATGCAGCCT
GGTATTTATGT -> GTATTTATGTA
GGTATTTTCAG -> GTATTTTCAGC
GGTCACGCAAC -> GTCACGCAACA
GGTCACTAACC -> GTCACTAACCG
GGTCCAGTTTG -> GTCCAGTTTGT
GGTCCGACACG -> GTCCGACACGA
GGTCCGGCGAT -> GTCCGGCGATA
GGTCCTACGAC -> GTCCTACGACA
GGTCGCCTCGT -> GTCGCCTCGTG
GGTGAAAACAC -> GTGAAAACACA
GGTGACGTACG -> GTGACGTACGG
GGTGAGCGTCG -> GTGAGCGTCGC
GGTGCACTCTA -> GTGCACTCTAG
GGTGCCTTTGC -> GTGCCTTTGCA
GGTGCGCAGGA -> GTGCGCAGGAA
GGTGGACTCCC -> GTGGACTCCCC
GGTGGTACCTG -> GTGGTACCTGC
GGTGGTATTTT -> GTGGTATTTTC
GGTGTCCACAG -> GTGTCCACAGG
GGTTAGCACGG -> GTTAGCACGGA
GGTTATCTTTG -> GTTATCTTTGA
GGTTCCGAAGG -> GTTCCGAAGGA
GGTTCTAAGTC -> GTTCTAAGTCT
GGTTGTGAATA -> GTTGTGAATAA
GGTTGTTGATA -> GTTGTTGATAC
GGTTTGCTGAA -> GTTTGCTGAAT
GTAAAGACAGC -> TAAAGACAGCG
GTAACAAGTGA -> TAACAAGTGAC
GTAACGCATGT -> TAACGCATGTG
GTAAGTGACAC -> TAAGTGACACA
GTAATACCATT -> TAATACCATTT
GTAATGGAACC -> TAATGGAACCA
GTAATTGGACA -> TAATTGGACAC
GTACACATGCC -> TACACATGCCC
GTACATTACCG -> TACATTACCGC
GTACCTGCAGC -> TACCTGCAGCA
GTACCTGTCCG -> TACCTGTCCGA
GTACGGGAGGC -> TACGGGAGGCA
GTACTATATCA -> TACTATATCAT
GTACTCAGTAG -> TACTCAGTAGG
GTAGAACGGCA -> TAGAACGGCAA
GTAGACCGGGT -> TAGACCGGGTC
GTAGATAGCGA -> TAGATAGCGAC
GTAGCATTGGT -> TAGCATTGGTC
GTAGCCCCTAT -> TAGCCCCTATT
GTAGCTCGCCC -> TAGCTCGCCCA
GTAGCTTGCTA -> TAGCTTGCTAC
GTAGGGGGCTA -> TAGGGGGCTAT
GTAGTCAGCGA -> TAGTCAGCGAT
GTATAGATAAT -> TATAGATAATT
GTATCAAGCAT -> TATCAAGCATG
GTATCTGGTTA -> TATCTGGTTAG
GTATGCAGCCT -> TATGCAGCCTC
GTATTGTCTCC -> TATTGTCTCCA
GTATTTAGTCG -> TATTTAGTCGG
GTATTTATGTA -> TATTTATGTAG
GTATTTTCAGC -> TATTTTCAGCG
GTCACCAGAAA -> TCACCAGAAAC
GTCACGCAACA -> TCACGCAACAG
GTCACTAACCG -> TCACTAACCGG
GTCAGCGATAC -> TCAGCGATACA
GTCCACAGGGA -> TCCACAGGGAG
GTCCAGTTTGT -> TCCAGTTTGTC
GTCCGACACGA -> TCCGACACGAG
GTCCGAGGGTG -> TCCGAGGGTGA
GTCCGGCGATA -> TCCGGCGATAA
GTCCGGGACCC -> TCCGGGACCCA
GTCCTACGACA -> TCCTACGACAC
GTCCTTACTAT -> TCCTTACTATT
GTCGACGTCTC -> TCGACGTCTCT
GTCGCCTCGTG -> TCGCCTCGTGC
GTCGCTCACCT -> TCGCTCACCTC
GTCGGCCCACG -> TCGGCCCACGA
GTCGTAGACCG -> TCGTAGACCGG
GTCTACAAAGA -> TCTACAAAGAA
GTCTACATAGG -> TCTACATAGGC
GTCTAGGCCAT -> TCTAGGCCATC
GTCTCCACTCA -> TCTCCACTCAC
GTCTCCATTAT -> TCTCCATTATT
GTCTCCCGGAT -> TCTCCCGGATA
GTCTCCGAGAT -> TCTCCGAGATA
GTCTCTAATGT -> TCTCTAATGTA
GTCTGCTTTTA -> TCTGCTTTTAC
GTGAAAACACA -> TGAAAACACAA
GTGAATAATAA -> TGAATAATAAT
GTGAATCTGGA -> TGAATCTGGAC
GTGACACAGGC -> TGACACAGGCC
GTGACGGTACA -> TGACGGTACAC
GTGACGTACGG -> TGACGTACGGG
GTGACTCTACC -> TGACTCTACCT
GTGAGAACATG -> TGAGAACATGG
GTGAGCGTCGC -> TGAGCGTCGCT
GTGCAACTATA -> TGCAACTATAG
GTGCACTCTAG -> TGCACTCTAGA
GTGCCCGTGGG -> TGCCCGTGGGA
GTGCCGGCAGA -> TGCCGGCAGAT
GTGCCGGCAGG -> TGCCGGCAGGG
GTGCCTAAATA -> TGCCTAAATAT
GTGCCTTTGCA -> TGCCTTTGCAG
GTGCGCAGGAA -> TGCGCAGGAAG
GTGCGCTTGAA -> TGCGCTTGAAG
GTGCTAGAGCC -> TGCTAGAGCCC
GTGCTATGTTC -> TGCTATGTTCA
GTGGACTCCCC -> TGGACTCCCCG
GTGGCAAATAG -> TGGCAAATAGT
GTGGCAAGCGA -> TGGCAAGCGAT
GTGGGATAATA -> TGGGATAATAA
GTGGTACCTGC -> TGGTACCTGCA
GTGGTAGCTCG -> TGGTAGCTCGC
GTGGTATTTTC -> TGGTATTTTCA
GTGTAATTGGA -> TGTAATTGGAC
GTGTAGAACGG -> TGTAGAACGGC
GTGTCCACAGG -> TGTCCACAGGG
GTGTGCAACTA -> TGTGCAACTAT
GTGTGCTAGAG -> TGTGCTAGAGC
GTGTGTTACTA -> TGTGTTACTAA
GTGTTAACAAC -> TGTTAACAACT
GTGTTACTAAA -> TGTTACTAAAT
GTGTTGACACT -> TGTTGACACTC
GTTAACAACTG -> TTAACAACTGC
GTTACCCTACC -> TTACCCTACCG
GTTACGTTTAT -> TTACGTTTATC
GTTACTAAATA -> TTACTAAATAA
GTTAGAAAACT -> TTAGAAAACTT
GTTAGCACGGA -> TTAGCACGGAT
GTTATAGATGC -> TTATAGATGCA
GTTATCTAATA -> TTATCTAATAT
GTTATCTTTGA -> TTATCTTTGAT
GTTATGGTGAG -> TTATGGTGAGC
GTTATTGTTAC -> TTATTGTTACG
GTTCAACGCCT -> TTCAACGCCTA
GTTCAGTGCCC -> TTCAGTGCCCG
GTTCCGAAGGA -> TTCCGAAGGAT
GTTCCGGGACT -> TTCCGGGACTC
GTTCTAAGTCT -> TTCTAAGTCTA
GTTGACAAGTA -> TTGACAAGTAC
GTTGACACTCT -> TTGACACTCTA
GTTGATACTCA -> TTGATACTCAC
GTTGGCTTGTA -> TTGGCTTGTAA
GTTGTATTTAG -> TTGTATTTAGT
GTTGTGAATAA -> TTGTGAATAAT
GTTGTTGATAC -> TTGTTGATACT
GTTTAAGGCTT -> TTTAAGGCTTC
GTTTATCCAAA -> TTTATCCAAAT
GTTTGCTGAAT -> TTTGCTGAATG
GTTTGGCGTGT -> TTTGGCGTGTA
GTTTGTAAAGA -> TTTGTAAAGAC
GTTTGTCGTAG -> TTTGTCGTAGA
TAAACTGGACT -> AAACTGGACTG
TAAAGACAGCG -> AAAGACAGCGC
TAAATAAGAGA -> AAATAAGAGAC
TAAATATGCAT -> AAATATGCATC
TAACAACTGCA -> AACAACTGCAC
TAACAAGTGAC -> AACAAGTGACG
TAACAATACGA -> AACAATACGAG
TAACACGTCTC -> AACACGTCTCC
TAACACTTCGC -> AACACTTCGCA
TAACCGGCGAG -> AACCGGCGAGC
TAACGCATGTG -> AACGCATGTGC
TAACGCCTGGC -> AACGCCTGGCG
TAAGAGACCGC -> AAGAGACCGCC
TAAGAGTCTGC -> AAGAGTCTGCT
TAAGATTGGAC -> AAGATTGGACA
TAAGCATACTC -> AAGCATACTCA
TAAGGACGTCA -> AAGGACGTCAC
TAAGGCTTCTC -> AAGGCTTCTCG
TAAGGGAGGTT -> AAGGGAGGTTC
TAAGTCTAGGC -> AAGTCTAGGCC
TAAGTGACACA -> AAGTGACACAG
TAATAAGATTG -> AATAAGATTGG
TAATAATGGTG -> AATAATGGTGG,AATAATGGTGC
TAATACCATTT -> AATACCATTTC
TAATATAAGAG -> AATATAAGAGT
TAATGCGCGGT -> AATGCGCGGTA
TAATGGAACCA -> AATGGAACCAT
TAATGGCCTCG -> AATGGCCTCGC
TAATGGTGCAC -> AATGGTGCACT
TAATGGTGGTA -> AATGGTGGTAC
TAATGTAATAC -> AATGTAATACC
TAATTACAGGC -> AATTACAGGCC
TAATTGGACAC -> AATTGGACACC
TAATTGTGTTA -> AATTGTGTTAA
TACAAAGAACA -> ACAAAGAACAA
TACAATCTGAC -> ACAATCTGACG
TACACATGCCC -> ACACATGCCCA
TACACCCGCCG -> ACACCCGCCGC
TACACGTCGAC -> ACACGTCGACG
TACAGGCCAGC -> ACAGGCCAGCG
TACATAAGGGA -> ACATAAGGGAG
TACATAGGCCC -> ACATAGGCCCA
TACATTACCGC -> ACATTACCGCT
TACATTCACCC -> ACATTCACCCT
TACCAGCTGGC -> ACCAGCTGGCA
TACCATTTCAG -> ACCATTTCAGG
TACCCACCTGC -> ACCCACCTGCT
TACCCCCGTGC -> ACCCCCGTGCC
TACCCTACCGT -> ACCCTACCGTT
TACCGCTACGT -> ACCGCTACGTA
TACCGTTATAG -> ACCGTTATAGA
TACCTCACCAG -> ACCTCACCAGG
TACCTGCAGCA -> ACCTGCAGCAG
TACCTGTCCGA -> ACCTGTCCGAG
TACGACACGGT -> ACGACACGGTA
TACGAGGTACC -> ACGAGGTACCT
TACGGGAGGCA -> ACGGGAGGCAG
TACGGTTATCT -> ACGGTTATCTT
TACGTATTGTC -> ACGTATTGTCT
TACGTGGCAAA -> ACGTGGCAAAT
TACGTTTATCC -> ACGTTTATCCA
TACTAAATAAG -> ACTAAATAAGA
TACTATATCAT -> ACTATATCATC
TACTATTTAGG -> ACTATTTAGGT
TACTCACAGCG -> ACTCACAGCGT
TACTCAGAGCA -> ACTCAGAGCAT
TACTCAGTAGG -> ACTCAGTAGGG
TACTCTCATAG -> ACTCTCATAGT
TACTCTTAACA -> ACTCTTAACAC
TACTGAGACCG -> ACTGAGACCGT
TAGAAAACTTC -> AGAAAACTTCT
TAGAACGGCAA -> AGAACGGCAAG
TAGACCGGGTC -> AGACCGGGTCC
TAGAGCCCCGA -> AGAGCCCCGAT
TAGAGGCCTAA -> AGAGGCCTAAG
TAGATAATTGT -> AGATAATTGTG
TAGATAGCGAC -> AGATAGCGACA
TAGATCACCAG -> AGATCACCAGG
TAGATGCATAT -> AGATGCATATG
TAGATGCCCGT -> AGATGCCCGTT
TAGCACGGATA -> AGCACGGATAT
TAGCAGCCAAT -> AGCAGCCAATT
TAGCATTGGTC -> AGCATTGGTCA
TAGCCCCTATT -> AGCCCCTATTG
TAGCCGGGCGC -> AGCCGGGCGCT
TAGCCTCCTCG -> AGCCTCCTCGA
TAGCGACAAGG -> AGCGACAAGGT
TAGCTCGCCCA -> AGCTCGCCCAA
TAGCTTGCTAC -> AGCTTGCTACT
TAGCTTGTGAA -> AGCTTGTGAAT
TAGGCATTTCA -> AGGCATTTCAC
TAGGCCATCAT -> AGGCCATCATC
TAGGCCCAGCA -> AGGCCCAGCAT
TAGGGGGCTAT -> AGGGGGCTATG
TAGGTAGTCAG -> AGGTAGTCAGC
TAGGTGGACTC -> AGGTGGACTCC
TAGTCAGCGAT -> AGTCAGCGATA
TAGTCCTTACT -> AGTCCTTACTA
TAGTCGGCCCA -> AGTCGGCCCAC
TAGTGAGAACA -> AGTGAGAACAT
TAGTTATCTAA -> AGTTATCTAAT
TATAAGAGTCT -> ATAAGAGTCTG
TATAGATAATT -> ATAGATAATTG
TATAGATGCAT -> ATAGATGCATA
TATAGCCTCCT -> ATAGCCTCCTC
TATAGGCATTT -> ATAGGCATTTC
TATAGTGAGAA -> ATAGTGAGAAC
TATATCACCGG -> ATATCACCGGT
TATATCATCGG -> ATATCATCGGG
TATCAAGCATG -> ATCAAGCATGC
TATCACCAATA -> ATCACCAATAA
TATCACCGGTA -> ATCACCGGTAA
TATCATACGGT -> ATCATACGGTT
TATCATCGGGT -> ATCATCGGGTG
TATCCAAATGA -> ATCCAAATGAC
TATCCCGCAAG -> ATCCCGCAAGA
TATCTAATATA -> ATCTAATATAA
TATCTGGTTAG -> ATCTGGTTAGC
TATCTTTGATT -> ATCTTTGATTC
TATGCAGCCTC -> ATGCAGCCTCG
TATGCATCACA -> ATGCATCACAT
TATGCCTAGCC -> ATGCCTAGCCG
TATGGAAAATG -> ATGGAAAATGT
TATGGTGAGCG -> ATGGTGAGCGT
TATGTAGCATT -> ATGTAGCATTG
TATGTTCAACG -> ATGTTCAACGC
TATTCCGAACA -> ATTCCGAACAT
TATTGCGTGTA -> ATTGCGTGTAA
TATTGTCTCCA -> ATTGTCTCCAC
TATTGTTACGT -> ATTGTTACGTT
TATTTAGGTAG -> ATTTAGGTAGT
TATTTAGTCGG -> ATTTAGTCGGC
TATTTATGTAG -> ATTTATGTAGC
TATTTTCAGCG -> ATTTTCAGCGT
TCAACGCCTAC -> CAACGCCTACA
TCAAGACTGCC -> CAAGACTGCCG
TCAAGCATGCA -> CAAGCATGCAC
TCAAGGGGAGG -> CAAGGGGAGGT
TCACAGCGTAA -> CACAGCGTAAT
TCACATATCCC -> CACATATCCCG
TCACCAATAAT -> CACCAATAATA
TCACCAGAAAC -> CACCAGAAACC
TCACCAGGAAG -> CACCAGGAAGT
TCACCAGGTCC -> CACCAGGTCCA
TCACCCTTTCA -> CACCCTTTCAA
TCACCGGTAAC -> CACCGGTAACA
TCACCGTGTGC -> CACCGTGTGCA
TCACCTCGACA -> CACCTCGACAG
TCACGCAACAG -> CACGCAACAGA
TCACGGTATGC -> CACGGTATGCA
TCACGTTAGAA -> CACGTTAGAAA
TCACTAACCGG -> CACTAACCGGC
TCAGAGCATCG -> CAGAGCATCGA
TCAGCGATACA -> CAGCGATACAT
TCAGCGTTGGC -> CAGCGTTGGCT
TCAGGAAGATA -> CAGGAAGATAC
TCAGGGTTGTT -> CAGGGTTGTTG
TCAGTAGGGGG -> CAGTAGGGGGC
TCAGTGCCCGT -> CAGTGCCCGTG
TCATACGGTTA -> CATACGGTTAT
TCATAGTTATC -> CATAGTTATCT
TCATCGGGTGG -> CATCGGGTGGT
TCATCGTTGAC -> CATCGTTGACA
TCATGTTATGG -> CATGTTATGGT
TCCAAATGACT -> CCAAATGACTC
TCCAAGGTGCG -> CCAAGGTGCGC
TCCACAGGGAG -> CCACAGGGAGA
TCCACCGATCA -> CCACCGATCAA
TCCACGGGTCG -> CCACGGGTCGC
TCCACTCACGG -> CCACTCACGGT
TCCAGTTTGTC -> CCAGTTTGTCG
TCCATTATTCC -> CCATTATTCCG
TCCCCGGCGTC -> CCCCGGCGTCT
TCCCCGTACTA -> CCCCGTACTAT
TCCCGCAAGAC -> CCCGCAAGACT
TCCCGGATACC -> CCCGGATACCC
TCCGAACATGC -> CCGAACATGCA
TCCGAAGGATC -> CCGAAGGATCA
TCCGACACGAG -> CCGACACGAGC
TCCGAGATAGC -> CCGAGATAGCA
TCCGAGGGTGA -> CCGAGGGTGAA
TCCGGATATCA -> CCGGATATCAT
TCCGGCGATAA -> CCGGCGATAAA
TCCGGGACCCA -> CCGGGACCCAT
TCCGGGACTCA -> CCGGGACTCAT
TCCGGGCTAAC -> CCGGGCTAACG
TCCTACGACAC -> CCTACGACACG
TCCTCGACGCA -> CCTCGACGCAG
TCCTGAGGGGT -> CCTGAGGGGTC
TCCTTACTATT -> CCTTACTATTT
TCGAAAAGTGC -> CGAAAAGTGCT
TCGACACCTCG -> CGACACCTCGT
TCGACAGGTTT -> CGACAGGTTTG
TCGACGCAGTG -> CGACGCAGTGG
TCGACGTCTCT -> CGACGTCTCTA
TCGAGAGTGTG -> CGAGAGTGTGC
TCGATCGAGAG -> CGATCGAGAGT
TCGCAACACAC -> CGCAACACACC
TCGCCCAATCA -> CGCCCAATCAC
TCGCCGGAGTG -> CGCCGGAGTGA
TCGCCTCGTGC -> CGCCTCGTGCG
TCGCCTGGACG -> CGCCTGGACGC
TCGCGGCTTAC -> CGCGGCTTACG
TCGCTCACCTC -> CGCTCACCTCG
TCGCTGATAGG -> CGCTGATAGGT
TCGCTGGGAGA -> CGCTGGGAGAT
TCGGCCCACGA -> CGGCCCACGAG
TCGGGTCCGAC -> CGGGTCCGACA
TCGGGTGGTAT -> CGGGTGGTATT
TCGGTTCCGAA -> CGGTTCCGAAG
TCGTAGACCGG -> CGTAGACCGGG
TCGTGCGCTTG -> CGTGCGCTTGA
TCGTGTGTTAC -> CGTGTGTTACT
TCGTTACCCTA -> CGTTACCCTAC
TCGTTGACAAG -> CGTTGACAAGT
TCGTTTGTAAA -> CGTTTGTAAAG
TCTAAGCATAC -> CTAAGCATACT
TCTAAGTCTAG -> CTAAGTCTAGG
TCTAATATAAG -> CTAATATAAGA
TCTAATGTAAT -> CTAATGTAATA
TCTACAAAGAA -> CTACAAAGAAC
TCTACATAGGC -> CTACATAGGCC
TCTACCTCACC -> CTACCTCACCA
TCTAGATGCCC -> CTAGATGCCCG
TCTAGGCCATC -> CTAGGCCATCA
TCTCATAGTTA -> CTCATAGTTAT
TCTCCACCGAT -> CTCCACCGATC
TCTCCACGGGT -> CTCCACGGGTC
TCTCCACTCAC -> CTCCACTCACG
TCTCCATTATT -> CTCCATTATTC
TCTCCCGGATA -> CTCCCGGATAC
TCTCCGAGATA -> CTCCGAGATAG
TCTCGGTTCCG -> CTCGGTTCCGA
TCTCGTTTGTA -> CTCGTTTGTAA
TCTCTAATGTA -> CTCTAATGTAA
TCTGACGCTGA -> CTGACGCTGAA
TCTGATCGCTG -> CTGATCGCTGA
TCTGATGCTAA -> CTGATGCTAAT
TCTGCTTTTAC -> CTGCTTTTACA
TCTGGACCCAG -> CTGGACCCAGT
TCTGGCACCCA -> CTGGCACCCAT
TCTGGTTAGCA -> CTGGTTAGCAC
TCTTAACACGT -> CTTAACACGTC
TCTTTGATTCG -> CTTTGATTCGC
TCTTTTTTCGG -> CTTTTTTCGGG
TGAAAACACAA -> GAAAACACAAT
TGAAGCTTACC -> GAAGCTTACCA
TGAATAATAAT -> GAATAATAATG
TGAATACTCTT -> GAATACTCTTA
TGAATCTGGAC -> GAATCTGGACC
TGAATGCTAAC -> GAATGCTAACA
TGACAAGTACA -> GACAAGTACAT
TGACACAACAT -> GACACAACATG
TGACACAGGCC -> GACACAGGCCT
TGACACTCTAA -> GACACTCTAAG
TGACGCTGAAT -> GACGCTGAATA
TGACGGTACAC -> GACGGTACACA
TGACGTACGGG -> GACGTACGGGA
TGACTCTACCT -> GACTCTACCTC
TGACTCTGGCA -> GACTCTGGCAC
TGAGAACATGG -> GAGAACATGGA
TGAGACCGTTC -> GAGACCGTTCC
TGAGCGTCGCT -> GAGCGTCGCTC
TGAGGGGTCAC -> GAGGGGTCACT
TGATACTCACA -> GATACTCACAG
TGATAGGTGGA -> GATAGGTGGAC
TGATCGCTGAT -> GATCGCTGATA
TGATGCTAATG -> GATGCTAATGC
TGATTCGCGGC -> GATTCGCGGCT
TGATTTAGCTT -> GATTTAGCTTG
TGCAACTATAG -> GCAACTATAGT
TGCAAGCCGCA -> GCAAGCCGCAA
TGCACAGACCA -> GCACAGACCAG
TGCACCGGCCA -> GCACCGGCCAA
TGCACCGGGAC -> GCACCGGGACA
TGCACTCTAGA -> GCACTCTAGAT
TGCAGACTTCC -> GCAGACTTCCA
TGCAGCAGGCA -> GCAGCAGGCAA
TGCAGCCTCGC -> GCAGCCTCGCT
TGCATATGGAA -> GCATATGGAAA
TGCATCACATA -> GCATCACATAT
TGCCCAGCCCG -> GCCCAGCCCGC
TGCCCGTGGGA -> GCCCGTGGGAT
TGCCCGTTTGG -> GCCCGTTTGGC
TGCCCTTAACA -> GCCCTTAACAC
TGCCGACACAG -> GCCGACACAGG
TGCCGGCAGAT -> GCCGGCAGATG
TGCCGGCAGGG -> GCCGGCAGGGG
TGCCTAAATAT -> GCCTAAATATG
TGCCTAGCCGG -> GCCTAGCCGGG
TGCCTTTGCAG -> GCCTTTGCAGA
TGCGCAGGAAG -> GCGCAGGAAGA
TGCGCGGTATC -> GCGCGGTATCA
TGCGCTTGAAG -> GCGCTTGAAGC
TGCGTGTAATT -> GCGTGTAATTG
TGCTAACAATA -> GCTAACAATAC
TGCTAATGCGC -> GCTAATGCGCG
TGCTACTCTCA -> GCTACTCTCAT
TGCTACTGAGA -> GCTACTGAGAC
TGCTAGAGCCC -> GCTAGAGCCCC
TGCTATGTTCA -> GCTATGTTCAA
TGCTGAATGCT -> GCTGAATGCTA
TGCTTAGATCA -> GCTTAGATCAC
TGCTTTTACAT -> GCTTTTACATA
TGGAAAATGTA -> GGAAAATGTAG
TGGAAAGTTAT -> GGAAAGTTATT
TGGAACCATCG -> GGAACCATCGA
TGGACACCGTC -> GGACACCGTCC
TGGACATGACA -> GGACATGACAC
TGGACCCAGTT -> GGACCCAGTTG
TGGACGCCGAC -> GGACGCCGACT
TGGACTCCCCG -> GGACTCCCCGG
TGGCAAAGCGT -> GGCAAAGCGTG
TGGCAAATAGT -> GGCAAATAGTC
TGGCAACGTCT -> GGCAACGTCTA
TGGCAAGCGAT -> GGCAAGCGATG
TGGCACCCATG -> GGCACCCATGC
TGGCACCTGGT -> GGCACCTGGTG
TGGCCTCGCCG -> GGCCTCGCCGG
TGGCGAGGTAG -> GGCGAGGTAGC
TGGCGTGTAGA -> GGCGTGTAGAA
TGGCTTGTAAC -> GGCTTGTAACG
TGGGAGATATA -> GGGAGATATAT
TGGGATAATAA -> GGGATAATAAG
TGGGGTTGTGA -> GGGGTTGTGAA
TGGTACCTGCA -> GGTACCTGCAG
TGGTAGCTCGC -> GGTAGCTCGCC
TGGTATTTTCA -> GGTATTTTCAG
TGGTCACGCAA -> GGTCACGCAAC
TGGTGAGCGTC -> GGTGAGCGTCG
TGGTGCACTCT -> GGTGCACTCTA
TGGTGGTACCT -> GGTGGTACCTG
TGGTGTCCACA -> GGTGTCCACAG
TGGTTAGCACG -> GGTTAGCACGG
TGTAAAGACAG -> GTAAAGACAGC
TGTAACGCATG -> GTAACGCATGT
TGTAATACCAT -> GTAATACCATT
TGTAATTGGAC -> GTAATTGGACA
TGTAGAACGGC -> GTAGAACGGCA
TGTAGATAGCG -> GTAGATAGCGA
TGTAGCATTGG -> GTAGCATTGGT
TGTAGCTTGCT -> GTAGCTTGCTA
TGTATTTAGTC -> GTATTTAGTCG
TGTCCACAGGG -> GTCCACAGGGA
TGTCCGAGGGT -> GTCCGAGGGTG
TGTCGTAGACC -> GTCGTAGACCG
TGTCTCCACTC -> GTCTCCACTCA
TGTGAATAATA -> GTGAATAATAA
TGTGAATCTGG -> GTGAATCTGGA
TGTGCAACTAT -> GTGCAACTATA
TGTGCCGGCAG -> GTGCCGGCAGA
TGTGCCTAAAT -> GTGCCTAAATA
TGTGCTAGAGC -> GTGCTAGAGCC
TGTGTTAACAA -> GTGTTAACAAC
TGTGTTACTAA -> GTGTTACTAAA
TGTTAACAACT -> GTTAACAACTG
TGTTACGTTTA -> GTTACGTTTAT
TGTTACTAAAT -> GTTACTAAATA
TGTTATGGTGA -> GTTATGGTGAG
TGTTCAACGCC -> GTTCAACGCCT
TGTTCAGTGCC -> GTTCAGTGCCC
TGTTGACACTC -> GTTGACACTCT
TGTTGATACTC -> GTTGATACTCA
TTAACAACTGC -> TAACAACTGCA
TTAACACGTCT -> TAACACGTCTC
TTAACACTTCG -> TAACACTTCGC
TTAAGGCTTCT -> TAAGGCTTCTC
TTAATGGCCTC -> TAATGGCCTCG
TTACAATCTGA -> TACAATCTGAC
TTACAGGCCAG -> TACAGGCCAGC
TTACATAAGGG -> TACATAAGGGA
TTACCAGCTGG -> TACCAGCTGGC
TTACCCTACCG -> TACCCTACCGT
TTACCGCTACG -> TACCGCTACGT
TTACGTGGCAA -> TACGTGGCAAA
TTACGTTTATC -> TACGTTTATCC
TTACTAAATAA -> TACTAAATAAG
TTACTATTTAG -> TACTATTTAGG
TTAGAAAACTT -> TAGAAAACTTC
TTAGATCACCA -> TAGATCACCAG
TTAGCACGGAT -> TAGCACGGATA
TTAGCTTGTGA -> TAGCTTGTGAA
TTAGGTAGTCA -> TAGGTAGTCAG
TTAGTCGGCCC -> TAGTCGGCCCA
TTATAGATGCA -> TATAGATGCAT
TTATAGGCATT -> TATAGGCATTT
TTATCCAAATG -> TATCCAAATGA
TTATCTAATAT -> TATCTAATATA
TTATCTTTGAT -> TATCTTTGATT
TTATGGTGAGC -> TATGGTGAGCG
TTATGTAGCAT -> TATGTAGCATT
TTATTCCGAAC -> TATTCCGAACA
TTATTGTTACG -> TATTGTTACGT
TTCAACGCCTA -> TCAACGCCTAC
TTCAAGGGGAG -> TCAAGGGGAGG
TTCACCCTTTC -> TCACCCTTTCA
TTCACCGTGTG -> TCACCGTGTGC
TTCAGCGTTGG -> TCAGCGTTGGC
TTCAGGGTTGT -> TCAGGGTTGTT
TTCAGTGCCCG -> TCAGTGCCCGT
TTCCAAGGTGC -> TCCAAGGTGCG
TTCCGAACATG -> TCCGAACATGC
TTCCGAAGGAT -> TCCGAAGGATC
TTCCGGATATC -> TCCGGATATCA
TTCCGGGACTC -> TCCGGGACTCA
TTCGACACCTC -> TCGACACCTCG
TTCGCAACACA -> TCGCAACACAC
TTCGCGGCTTA -> TCGCGGCTTAC
TTCGGGTCCGA -> TCGGGTCCGAC
TTCGTTACCCT -> TCGTTACCCTA
TTCTAAGTCTA -> TCTAAGTCTAG
TTCTCCACGGG -> TCTCCACGGGT
TTCTCGTTTGT -> TCTCGTTTGTA
TTCTGATGCTA -> TCTGATGCTAA
TTGAAGCTTAC -> TGAAGCTTACC
TTGACAAGTAC -> TGACAAGTACA
TTGACACTCTA -> TGACACTCTAA
TTGATACTCAC -> TGATACTCACA
TTGATTCGCGG -> TGATTCGCGGC
TTGCAGACTTC -> TGCAGACTTCC
TTGCGTGTAAT -> TGCGTGTAATT
TTGCTACTCTC -> TGCTACTCTCA
TTGCTGAATGC -> TGCTGAATGCT
TTGGACACCGT -> TGGACACCGTC
TTGGACATGAC -> TGGACATGACA
TTGGCACCTGG -> TGGCACCTGGT
TTGGCGTGTAG -> TGGCGTGTAGA
TTGGCTTGTAA -> TGGCTTGTAAC
TTGGTCACGCA -> TGGTCACGCAA
TTGTAAAGACA -> TGTAAAGACAG
TTGTAACGCAT -> TGTAACGCATG
TTGTATTTAGT -> TGTATTTAGTC
TTGTCGTAGAC -> TGTCGTAGACC
TTGTCTCCACT -> TGTCTCCACTC
TTGTGAATAAT -> TGTGAATAATA
TTGTGAATCTG -> TGTGAATCTGG
TTGTGTTAACA -> TGTGTTAACAA
TTGTTACGTTT -> TGTTACGTTTA
TTGTTGATACT -> TGTTGATACTC
TTTAAGGCTTC -> TTAAGGCTTCT
TTTAATGGCCT -> TTAATGGCCTC
TTTACATAAGG -> TTACATAAGGG
TTTAGCTTGTG -> TTAGCTTGTGA
TTTAGGTAGTC -> TTAGGTAGTCA
TTTAGTCGGCC -> TTAGTCGGCCC
TTTATAGGCAT -> TTATAGGCATT
TTTATCCAAAT -> TTATCCAAATG
TTTATGTAGCA -> TTATGTAGCAT
TTTCAAGGGGA -> TTCAAGGGGAG
TTTCACCGTGT -> TTCACCGTGTG
TTTCAGCGTTG -> TTCAGCGTTGG
TTTCAGGGTTG -> TTCAGGGTTGT
TTTCGGGTCCG -> TTCGGGTCCGA
TTTCGTTACCC -> TTCGTTACCCT
TTTGATTCGCG -> TTGATTCGCGG
TTTGCAGACTT -> TTGCAGACTTC
TTTGCTGAATG -> TTGCTGAATGC
TTTGGCGTGTA -> TTGGCGTGTAG
TTTGTAAAGAC -> TTGTAAAGACA
TTTGTCGTAGA -> TTGTCGTAGAC
TTTTACATAAG -> TTTACATAAGG
TTTTCAGCGTT -> TTTCAGCGTTG
TTTTCGGGTCC -> TTTCGGGTCCG
TTTTTCGGGTC -> TTTTCGGGTCC
TTTTTTCGGGT -> TTTTTCGGGTC
